Species,G,C,A,T,Other (W\M\Y\R\S...),mtDNA size (bp),
Abacion magnum,186,56,220,211,1,674,
Abalistes stellaris,234,80,182,187,0,683,
Abbottina obtusirostris,197,98,203,186,0,684,
Abbottina rivularis,209,97,188,190,0,684,
Abidama producta,88,60,227,291,0,666,
Abisara fylloides,91,55,293,248,0,687,
Abispa ephippium,98,33,294,244,0,669,
Ablennes hians,207,83,214,180,0,684,
Abramis brama,183,94,204,203,0,684,
Abronia graminea,199,66,195,223,0,683,
Abrota ganga,84,57,312,225,0,678,
Abudefduf vaigiensis,224,88,194,177,0,683,
Acanella eburnea,116,124,279,195,0,714,
Acanthacorydalis orientalis,111,64,285,215,0,675,
Acanthaluteres brownii,223,99,203,158,0,683,
Acanthaster brevispinus,212,95,182,204,0,693,
Acanthaster planci,205,104,191,193,0,693,
Acanthocardia tuberculata,110,155,275,172,0,712,
Acanthocheilonema viteae,40,105,338,102,0,585,
Acanthogobius hasta,201,92,217,174,0,684,
Acanthopagrus latus,218,90,211,165,0,684,
Acanthopagrus schlegelii,211,87,220,166,0,684,
Acanthorhodeus chankaensis,187,97,216,184,0,684,
Acanthosaura armata,273,90,193,262,0,818,
Acanthurus leucosternon,217,85,198,183,0,683,
Acanthurus lineatus,220,83,198,182,0,683,
Acantopsis choirorhynchos,182,92,207,203,0,684,
Accipiter gentilis,247,60,162,215,0,684,
Accipiter nisus,247,59,169,209,0,684,
Accipiter virgatus,254,66,156,208,0,684,
Acentrogobius chlorostigmatoides,209,89,204,182,0,684,
Acentrogobius pflaumii,218,111,195,160,0,684,
Acerella muscorum,66,56,311,236,0,669,
Acerentomon microrhinus,102,118,266,189,0,675,
Aceros waldeni,255,69,158,202,0,684,
Acetes chinensis,143,85,247,200,0,675,
Achalinus meiguensis,239,80,170,186,0,675,
Achatina fulica,132,107,255,163,0,657,
Acheilognathus imberbis,195,97,210,182,0,684,
Acheilognathus intermedia,203,104,208,169,0,684,
Acheilognathus koreensis,201,112,207,164,0,684,
Acheilognathus macropterus,187,99,216,182,0,684,
Acheilognathus signifer,203,109,204,168,0,684,
Acheilognathus somjinensis,204,99,207,174,0,684,
Acheilognathus typus,191,97,204,192,0,684,
Acheilognathus yamatsutae,195,92,205,192,0,684,
Achelia bituberculata,68,66,306,227,0,667,
Achirus lineatus,234,93,188,169,0,684,
Acinonyx jubatus,186,78,206,211,0,681,
Acipenser baerii,232,92,177,183,0,684,
Acipenser dabryanus,238,90,172,184,0,684,
Acipenser gueldenstaedtii,233,91,175,185,0,684,
Acipenser ruthenus,226,91,183,184,0,684,
Acipenser schrenckii,236,92,173,183,0,684,
Acipenser sinensis,233,90,176,185,0,684,
Acipenser stellatus,231,94,178,181,0,684,
Acipenser transmontanus,235,94,174,180,0,683,
Acleris fimbriana,86,60,300,232,0,678,
Acmaeodera sp.,155,78,224,215,0,672,
Acomys cahirinus,209,69,192,211,0,681,
Acraea issoria,97,53,289,239,0,678,
Acreichthys tomentosus,203,91,215,174,0,683,
Acrida cinerea,99,62,243,274,0,678,
Acrida willemsei,98,60,244,274,0,676,
Acridotheres cristatellus,259,76,154,195,0,684,
Acrocephalus scirpaceus,244,81,160,199,0,684,
Acrochordus granulatus,165,54,203,258,0,680,
Acroneuria hainana,195,90,217,176,0,678,
Acropora aspera,101,160,289,149,0,699,
Acropora digitifera,101,160,289,149,0,699,
Acropora divaricata,101,160,289,149,0,699,
Acropora florida,101,160,289,149,0,699,
Acropora horrida,101,160,289,149,0,699,
Acropora humilis,101,160,289,149,0,699,
Acropora hyacinthus,101,160,289,149,0,699,
Acropora muricata,101,160,289,149,0,699,
Acropora nasuta,101,160,289,149,0,699,
Acropora robusta,101,160,289,149,0,699,
Acropora tenuis,101,160,289,149,0,699,
Acropora yongei,101,160,289,149,0,699,
Acrossocheilus barbodon,207,87,176,213,0,683,
Acrossocheilus fasciatus,199,88,186,211,0,684,
Acrossocheilus hemispinus,198,92,190,204,0,684,
Acrossocheilus kreyenbergii,193,87,194,210,0,684,
Acrossocheilus monticola,192,93,188,211,0,684,
Acrossocheilus parallens,193,93,193,205,0,684,
Acrossocheilus stenotaeniatus,199,92,184,209,0,684,
Acrossocheilus wenchowensis,195,89,190,210,0,684,
Acryllium vulturinum,255,67,166,196,0,684,
Actias selene,100,54,306,218,0,678,
Acyrthosiphon pisum,84,33,282,249,0,648,
Addax nasomaculatus,190,78,196,217,0,681,
Adelium sp.,119,77,242,228,0,666,
Adelphocoris fasciaticollis,93,63,240,288,0,684,
Adelphocoris lineolatus,96,62,238,288,0,684,
Adelphocoris nigritylus,96,63,239,286,0,684,
Adoxophyes honmai,94,56,299,232,0,681,
Adoxophyes orana,95,58,299,226,0,678,
Aedes aegypti,110,74,281,216,0,681,
Aedes albopictus,108,68,288,217,0,681,
Aedes notoscriptus,99,68,290,224,0,681,
Aegithalos bonvaloti,252,71,170,191,0,684,
Aegithalos fuliginosus,254,71,168,191,0,684,
Aegithalos glaucogularis,253,68,169,194,0,684,
Aegotheles cristatus,242,70,173,199,0,684,
Aegypius monachus,253,68,163,200,0,684,
Aelurostrongylus abstrusus,33,127,335,105,0,600,
Aeneolamia contigua,100,61,215,290,0,666,
Aeolesthes oenochrous,141,69,233,226,0,669,
Aeoliscus strigatus,240,98,180,165,0,683,
Aepyceros melampus,188,69,192,232,0,681,
Aeschyntelus notatus,100,69,251,249,0,669,
Aesopia cornuta,230,78,212,164,0,684,
Aethaloperca rogaa,195,78,201,210,0,684,
Aetobatus flagellum,208,74,206,196,0,684,
Agamermis sp.,60,54,238,173,0,525,
Agapornis roseicollis,269,71,155,189,0,684,
Agaricia humilis,105,159,284,151,0,699,
Agelaius phoeniceus,240,75,171,198,0,684,
Agelas schmidti,117,125,297,196,0,735,
Ageneiosus pardalis,204,80,194,206,0,684,
Agkistrodon piscivorus,226,76,179,200,0,681,
Agonostomus monticola,216,91,199,178,0,684,
Agriosphodrus dohrni,107,89,256,232,0,684,
Agrotis ipsilon,89,57,300,232,0,678,
Agrotis segetum,87,61,302,228,0,678,
Ahamus yunnanensis,81,52,304,241,0,678,
Ailuropoda melanoleuca,162,87,229,203,0,681,
Ailurus fulgens,180,75,213,213,0,681,
Ailurus fulgens,180,73,212,216,0,681,
Aiptasia pulchella,116,135,265,174,0,690,
Aix galericulata,251,84,157,192,0,684,
Akodon montensis,202,70,204,205,0,681,
Alatina moseri,137,147,276,154,0,714,
Alauda arvensis,268,70,150,196,0,684,
Albinaria caerulea,103,82,249,209,0,643,
Albula glossodonta,162,149,243,129,0,683,
Alburnus alburnus,191,115,200,178,0,684,
Alburnus istanbulensis,192,108,198,186,0,684,
Alburnus tarichi,190,116,201,177,0,684,
Alcelaphus buselaphus,208,82,178,213,0,681,
Alces alces,179,74,210,218,0,681,
Aldrichetta forsteri,232,90,188,174,0,684,
Aldrichina grahami,96,68,289,225,0,678,
Aldrovandia affinis,217,94,187,185,0,683,
Alectis ciliaris,209,83,210,182,0,684,
Alectoris chukar,255,73,162,194,0,684,
Alectura lathami,255,78,173,178,0,684,
Alepes kleinii,205,92,214,167,0,678,
Alepocephalus agassizii,238,92,181,172,0,683,
Alepocephalus australis,238,90,181,175,0,684,
Alepocephalus bairdii,237,94,179,173,0,683,
Alepocephalus bicolor,228,93,191,172,0,684,
Alepocephalus productus,235,90,184,174,0,683,
Alepocephalus tenebrosus,233,91,183,176,0,683,
Alepocephalus umbriceps,234,90,185,175,0,684,
Aleurochiton aceris,64,90,326,171,0,651,
Aleurodicus dugesii,37,63,338,213,0,651,
Aleuroglyphus ovatus,94,117,338,123,0,672,
Allantus luctifer,80,50,292,247,0,669,
Allenopithecus nigroviridis,206,61,192,222,0,681,
Alligator mississippiensis,229,66,179,204,0,678,
Alligator sinensis,225,84,184,191,0,684,
Allocricetulus eversmanni,199,86,193,203,0,681,
Allocyttus niger,204,84,221,174,0,683,
Alloeorhynchus bakeri,109,77,263,235,0,684,
Allonautilus scrobiculatus,228,79,234,155,0,696,
Alopias pelagicus,194,71,208,211,0,684,
Alopias superciliosus,186,75,211,212,0,684,
Alosa alosa,214,104,189,176,0,683,
Alosa pseudoharengus,210,93,196,184,0,683,
Alosa sapidissima,219,97,190,178,0,684,
Alouatta caraya,203,63,193,222,0,681,
Alpheus distinguendus,203,92,198,182,0,675,
Alulatettix yunnanensis,94,63,239,276,0,672,
Aluterus scriptus,256,96,170,161,0,683,
Alvinocaris chelys,192,98,222,163,0,675,
Alvinocaris longirostris,191,101,211,172,0,675,
Alytes obstetricans,240,81,183,179,0,683,
Amalda northlandica,113,107,294,182,0,696,
Amanses scopas,252,92,183,156,0,683,
Amata formosae,108,51,291,228,0,678,
Amaurornis akool,234,68,171,211,0,684,
Amaurornis phoenicurus,219,70,181,214,0,684,
Amazilia versicolor,244,70,169,201,0,684,
Amazonsprattus scintilla,187,101,221,175,0,684,
Amblyomma cajennense,91,65,304,206,0,666,
Amblyomma elaphense,66,55,324,218,0,663,
Amblyomma sphenodonti,73,65,310,218,0,666,
Amblyomma triguttatum,81,56,317,209,0,663,
Amblyraja radiata,189,78,218,199,0,684,
Amblyramphus holosericeus,242,75,168,199,0,684,
Ambystoma andersoni,150,75,247,212,0,684,
Ambystoma barbouri,163,77,226,218,0,684,
Ambystoma californiense,147,76,249,212,0,684,
Ambystoma dumerilii,156,77,241,210,0,684,
Ambystoma laterale,152,77,236,219,0,684,
Ambystoma mexicanum,149,75,248,212,0,684,
Ambystoma texanum,152,76,237,219,0,684,
Ambystoma tigrinum,153,74,239,218,0,684,
Ambystoma unisexual,157,76,232,219,0,684,
Amia calva,206,83,194,201,0,684,
Ammodytes hexapterus,233,94,206,151,0,684,
Ammodytes personatus,231,99,205,148,0,683,
Ammothea carolinensis,71,42,296,259,0,668,
Ammotragus lervia,193,74,195,219,0,681,
Amolops mantzorum,222,77,221,157,0,677,
Amolops ricketti,191,67,243,181,0,682,
Amolops tormotus,207,75,216,178,0,676,
Amolops wuyiensis,191,72,237,176,0,676,
Amoya chusanensis,205,88,212,179,0,684,
Amphiascoides atopus,166,80,265,180,0,691,
Amphibalanus amphitrite,103,80,284,199,0,666,
Amphilophus citrinellus,231,85,188,180,0,684,
Amphimedon compressa,125,143,259,199,0,726,
Amphimedon queenslandica,94,184,255,172,0,705,
Amphiporus formidabilis,66,161,355,109,0,691,
Amphiprion bicinctus,205,85,202,191,0,683,
Amphiprion clarkii,212,86,196,189,0,683,
Amphiprion frenatus,203,81,202,197,0,683,
Amphiprion ocellaris,223,96,177,187,0,683,
Amphiprion percula,220,88,182,193,0,683,
Amphiprion perideraion,202,85,201,195,0,683,
Amphiprion polymnus,206,86,200,191,0,683,
Amphisbaena schmidti,229,66,171,214,0,680,
Amplexidiscus fenestrafer,95,151,290,163,0,699,
Amynthas aspergillus,181,90,212,211,0,694,
Anabas testudineus,232,97,188,166,0,683,
Anabrus simplex,162,69,254,191,0,676,
Anacropora matthai,104,166,281,148,0,699,
Anadara sativa,43,117,232,133,0,525,
Anarchias sp.,216,93,191,183,0,683,
Anarhichas lupus,213,96,210,165,0,684,
Anas acuta,260,84,150,190,0,684,
Anas crecca,255,83,155,191,0,684,
Anas falcata,259,83,152,190,0,684,
Anas formosa,254,84,161,185,0,684,
Anas platyrhynchos,256,80,153,195,0,684,
Anas poecilorhyncha,255,81,154,194,0,684,
Anchoviella sp.,201,83,206,194,0,684,
Ancylostoma caninum,36,99,291,174,0,600,
Ancylostoma duodenale,36,98,306,160,0,600,
Andinoacara rivulatus,193,78,220,192,0,683,
Andrias davidianus,155,76,249,202,0,682,
Andrias japonicus,146,82,248,208,0,684,
Aneides flavipunctatus,145,75,247,216,1,684,
Aneides hardii,156,72,237,219,0,684,
Angaracris barabensis,103,59,249,267,0,678,
Angaracris rhodopa,105,60,247,266,0,678,
Angiostrongylus cantonensis,32,127,306,135,0,600,
Angiostrongylus costaricensis,35,132,293,140,0,600,
Angiostrongylus vasorum,31,162,303,104,0,600,
Anguilla anguilla,184,87,196,216,0,683,
Anguilla australis,182,86,200,215,0,683,
Anguilla australis,184,86,197,216,0,683,
Anguilla bengalensis,192,88,192,211,0,683,
Anguilla bicolor,176,83,207,217,0,683,
Anguilla bicolor,177,82,207,217,0,683,
Anguilla celebesensis,189,80,195,219,0,683,
Anguilla dieffenbachii,184,87,194,218,0,683,
Anguilla interioris,187,83,194,219,0,683,
Anguilla japonica,183,89,201,210,0,683,
Anguilla luzonensis,185,86,196,216,0,683,
Anguilla malgumora,183,83,196,221,0,683,
Anguilla marmorata,180,83,198,222,0,683,
Anguilla megastoma,191,80,193,219,0,683,
Anguilla mossambica,185,88,195,215,0,683,
Anguilla nebulosa,192,87,192,212,0,683,
Anguilla obscura,181,81,200,221,0,683,
Anguilla reinhardtii,189,85,196,213,0,683,
Anguilla rostrata,176,88,200,219,0,683,
Anguis fragilis,229,76,180,199,0,684,
Anilius scytale,189,65,202,225,0,681,
Anisakis simplex,53,126,298,123,0,600,
Anisakis simplex,54,122,297,127,0,600,
Anodonta anatina,70,171,313,148,0,702,
Anodonta arcaeformis,65,185,294,158,0,702,
Anodonta euscaphys,71,186,289,156,0,702,
Anodonta lucida,69,186,294,153,0,702,
Anodontostoma chacunda,203,114,198,168,0,683,
Anolis carolinensis,170,76,227,211,0,684,
Anomalops katoptron,222,91,180,189,1,683,
Anomalopteryx didiformis,261,64,166,193,0,684,
Anomalurus sp.,186,68,202,225,0,681,
Anopheles albitarsis,99,75,287,220,0,681,
Anopheles cracens,100,77,278,226,0,681,
Anopheles cruzii,92,75,290,224,0,681,
Anopheles darlingi,102,74,274,231,0,681,
Anopheles deaneorum,102,76,281,222,0,681,
Anopheles farauti,99,69,288,225,0,681,
Anopheles funestus,23,22,72,66,498,681,
Anopheles gambiae,100,74,286,221,0,681,
Anopheles hinesorum,100,71,278,232,0,681,
Anopheles quadrimaculatus,108,72,274,227,0,681,
Anoplocapros lenticularis,212,89,204,178,0,683,
Anoplogaster cornuta,217,87,196,184,0,684,
Anoplophora glabripennis,89,62,289,232,0,672,
Anoplopoma fimbria,230,101,190,163,0,684,
Anoura caudifer,181,72,220,208,0,681,
Anourosorex squamipes,170,68,217,226,0,681,
Anoxypristis cuspidata,193,70,206,219,0,688,
Anser albifrons,255,65,162,202,0,684,
Anser anser,250,63,166,205,0,684,
Anser cygnoides,251,63,165,205,0,684,
Anser fabalis,238,75,159,212,0,684,
Anser indicus,251,63,165,205,0,684,
Anseranas semipalmata,231,69,176,208,0,684,
Antedon mediterranea,89,90,361,150,0,690,
Antheraea frithi,94,52,321,211,0,678,
Antheraea pernyi,90,55,322,211,0,678,
Antheraea yamamai,88,52,328,210,0,678,
Anthocharis bambusarum,87,50,310,231,0,678,
Anthropoides paradiseus,232,61,175,216,0,684,
Anthropoides virgo,228,63,179,214,0,684,
Antidorcas marsupialis,179,70,206,226,0,681,
Antigonia capros,219,88,204,172,0,683,
Antilocapra americana,195,76,189,221,0,681,
Antilope cervicapra,189,76,196,220,0,681,
Antricola mexicanus,120,55,255,239,0,669,
Antrokoreana gracilipes,157,118,236,165,0,676,
Anyperodon leucogrammicus,217,80,198,189,0,684,
Aotus azarai,178,70,214,219,0,681,
Aotus azarai,178,70,214,219,0,681,
Aotus lemurinus,187,71,206,217,0,681,
Aotus nancymaae,183,73,211,214,0,681,
Apalone ferox,214,61,162,247,0,684,
Apalone spinifera,219,64,162,239,0,684,
Apareiodon affinis,200,82,202,199,0,683,
Apatides fortis,162,70,205,224,0,661,
Apatura ilia,87,51,281,235,0,654,
Apatura metis,93,53,287,245,0,678,
Apeltes quadracus,211,90,207,176,0,684,
Aphanopus carbo,236,99,182,166,0,683,
Aphelasterias japonica,146,103,257,187,0,693,
Aphelenchoides besseyi,57,79,305,144,0,585,
Aphis gossypii,85,35,285,249,0,654,
Aphredoderus sayanus,218,82,187,196,0,683,
Aphrocallistes vastus,150,57,229,293,0,729,
Aphyocypris chinensis,183,90,208,193,0,674,
Aphyocypris kikuchii,185,91,209,199,0,684,
Apis cerana,72,38,320,248,0,678,
Apis florea,68,36,322,255,0,681,
Apis mellifera,66,38,317,260,0,681,
Aplidium conicum,66,84,303,165,0,618,
Aplocheilus panchax,194,86,218,186,0,684,
Aplysia californica,104,107,262,193,0,666,
Aplysia dactylomela,114,114,254,184,0,666,
Aplysia kurodai,127,113,264,168,0,672,
Aplysina cauliformis,105,113,296,221,0,735,
Aplysina fulva,105,113,296,221,0,735,
Apocheima cinerarium,91,61,288,238,0,678,
Apochrysa matsumurae,86,72,292,225,0,675,
Apodemia mormo,80,52,321,225,0,678,
Apodemus agrarius,175,69,221,216,0,681,
Apodemus chejuensis,175,71,219,216,0,681,
Apodemus chevrieri,180,67,213,221,0,681,
Apodemus draco,184,67,203,227,0,681,
Apodemus latronum,185,64,204,228,0,681,
Apodemus peninsulae,170,65,222,224,0,681,
Apogon semilineatus,203,101,219,160,0,683,
Apolemichthys kingi,218,93,196,176,0,683,
Apolygus lucorum,99,80,240,292,0,711,
Aponomma fimbriatum,91,54,301,217,0,663,
Aporia crataegi,84,50,298,246,0,678,
Aporia intercostata,87,51,297,243,0,678,
Apostichopus japonicus,151,112,222,199,0,684,
Appalachioria falcifera,74,167,314,133,0,688,
Aprasia parapulchella,241,62,180,198,0,681,
Apteronotus albifrons,211,80,194,198,0,683,
Apteryx haastii,228,60,192,204,0,684,
Aptocyclus ventricosus,237,86,191,169,0,683,
Apus apus,249,66,167,202,0,684,
Aquarius paludum,97,61,244,265,0,667,
Aquatica leii,94,69,270,242,0,675,
Aquila chrysaetos,248,71,166,199,0,684,
Ara glaucogularis,246,70,166,202,0,684,
Arachnocampa flava,96,61,300,221,0,678,
Araneus ventricosus,69,99,292,203,0,663,
Arapaima gigas,193,75,220,196,0,684,
Aratinga acuticaudata,254,64,160,206,0,684,
Aratinga brevipes,252,65,163,204,0,684,
Aratinga pertinax,260,70,156,197,0,683,
Arbacia lixula,154,106,252,184,0,696,
Arborophila ardens,246,65,175,198,0,684,
Arborophila brunneopectus,238,67,180,199,0,684,
Arborophila rufipectus,245,66,179,194,0,684,
Arborophila rufogularis,244,68,180,192,0,684,
Archilochus colubris,238,71,176,199,0,684,
Architeuthis dux,159,62,245,227,0,693,
Arconaia lanceolata,77,194,303,128,0,702,
Arctica islandica,77,160,324,183,0,744,
Arctocephalus forsteri,202,82,194,203,0,681,
Arctocephalus pusillus,205,78,189,209,0,681,
Arctocephalus townsendi,202,85,193,201,0,681,
Arctodus simus,187,94,207,191,0,679,
Arctogadus glacialis,187,89,234,173,0,683,
Arctonyx collaris,188,74,205,214,0,681,
Arctoscopus japonicus,228,104,198,154,0,684,
Arcyptera coreana,90,62,259,267,0,678,
Ardea cinerea,255,71,153,205,0,684,
Ardea intermedia,245,69,162,208,0,684,
Ardea modesta,245,70,166,203,0,684,
Ardea novaehollandiae,246,68,165,205,0,684,
Ardea purpurea,255,66,154,209,0,684,
Ardeola bacchus,241,61,158,224,0,684,
Arenaria interpres,245,66,185,188,0,684,
Argas africolumbae,118,52,269,230,0,669,
Argas lagenoplastis,128,56,261,224,0,669,
Argas miniatus,101,47,301,220,0,669,
Argiope amoena,81,114,287,181,0,663,
Argiope bruennichi,71,105,297,190,0,663,
Argopecten irradians,113,213,297,127,0,750,
Argopecten irradians,114,213,296,127,0,750,
Argulus americanus,91,59,306,205,0,661,
Argynnis childreni,102,57,292,227,0,678,
Argynnis hyperbius,101,54,291,232,0,678,
Argyroneta aquatica,58,130,297,182,2,669,
Argyrosomus amoyensis,240,96,187,161,0,684,
Argyrosomus japonicus,239,96,188,161,0,684,
Ariadne ariadne,106,59,287,226,0,678,
Ariomma indica,202,81,217,183,0,683,
Ariomma lurida,228,83,196,176,0,683,
Ariosoma shiroanago,180,90,209,204,0,683,
Armillifer armillatus,255,24,187,188,0,654,
Arnoglossus polyspilus,240,105,183,155,0,683,
Arothron firmamentum,242,94,181,166,0,683,
Arothron hispidus,246,89,178,170,0,683,
Arothron manilensis,251,84,171,177,0,683,
Arripis trutta,226,93,197,167,0,683,
Artemia franciscana,129,100,259,172,0,660,
Artemia tibetiana,148,115,233,164,0,660,
Artemia urmiana,152,118,232,158,0,660,
Artibeus jamaicensis,173,72,224,212,0,681,
Artibeus lituratus,175,75,222,209,0,681,
Ascalohybris subjacens,111,72,256,239,0,678,
Ascaloptynx appendiculatus,115,65,256,239,0,675,
Ascaridia columbae,47,130,292,128,0,597,
Ascaridia galli,48,133,310,106,0,597,
Ascaris lumbricoides,41,132,309,118,0,600,
Ascaris suum,40,132,310,118,0,600,
Ascidiella aspersa,88,171,283,94,0,636,
Ascobulla fragilis,114,106,268,172,0,660,
Ascoschoengastia sp.,101,92,270,185,0,648,
Aseraggodes kobensis,215,70,193,206,0,684,
Ashtoret lunaris,127,82,266,200,0,675,
Asiotmethis jubatus,114,70,251,243,0,678,
Asiotmethis zacharjini,115,68,249,246,0,678,
Aspasma minima,184,80,250,169,0,683,
Aspidoparia morar,212,114,175,182,0,683,
Aspidytes niobe,95,61,275,250,0,681,
Aspiorhynchus laticeps,179,104,200,200,0,683,
Assurger anzac,235,102,190,156,0,683,
Astacopsis gouldi,174,82,232,187,0,675,
Astatotilapia calliptera,241,88,191,163,0,683,
Asterias amurensis,134,92,267,200,0,693,
Astrangia sp.,86,115,324,153,0,678,
Astreopora explanata,97,154,290,158,0,699,
Astreopora myriophthalma,98,154,289,158,0,699,
Astronotus ocellatus,204,85,212,182,0,683,
Astropecten polyacanthus,171,88,219,215,0,693,
Asymmetron inferum,169,104,226,186,0,685,
Asymmetron lucayanum,171,101,230,183,0,685,
Asymmetron sp.,167,120,232,166,0,685,
Ataxolepis apus,217,81,206,179,0,683,
Ateleopus japonicus,203,91,190,199,0,683,
Ateles belzebuth,196,65,199,221,0,681,
Atelura formicaria,176,99,216,182,0,673,
Athyma asura,85,55,317,221,0,678,
Athyma cama,90,55,308,224,1,678,
Athyma kasa,96,56,305,221,0,678,
Athyma opalina,92,55,302,229,0,678,
Athyma perius,85,57,306,229,1,678,
Athyma selenophora,81,55,311,231,0,678,
Athyma sulpitia,84,54,316,224,0,678,
Atlantoraja castelnaui,166,67,233,218,0,684,
Atractomorpha sinensis,98,63,235,279,0,675,
Atractosteus tropicus,224,92,182,186,0,684,
Atrina pectinata,59,197,291,155,0,702,
Atrocalopteryx atrata,125,90,214,255,0,684,
Atrophaneura alcinous,93,52,308,225,0,678,
Attacus atlas,104,53,303,218,0,678,
Atule mate,205,88,213,172,0,678,
Atympanophrys shapingensis,201,75,230,176,0,682,
Auchenoglanis occidentalis,227,78,165,213,0,683,
Aulichthys japonicus,194,87,226,176,0,683,
Aulopus japonicus,232,90,201,161,0,684,
Aulorhynchus flavidus,169,74,247,193,0,683,
Aulostomus chinensis,239,96,187,161,0,683,
Aurelia aurita,99,118,283,205,0,705,
Auriculinella bidentata,129,161,239,114,0,643,
Auriglobus modestus,232,86,188,180,0,686,
Austinogebia edulis,115,77,276,207,0,675,
Austinograea alayseae,157,78,249,191,0,675,
Austinograea rodriguezensis,150,74,260,191,0,675,
Austropotamobius pallipes,112,131,269,163,0,675,
Auxis rochei,229,95,188,172,0,684,
Auxis thazard,227,97,186,174,0,684,
Avahi laniger,215,84,189,193,0,681,
Avocettina infans,186,110,208,179,0,683,
Axinella corrugata,109,136,291,198,1,735,
Axis axis,170,79,215,217,0,681,
Axis porcinus,177,85,209,210,0,681,
Aythya americana,253,78,159,194,0,684,
Aythya ferina,253,77,159,195,0,684,
Aythya fuligula,254,79,159,192,0,684,
Babina adenopleura,199,77,238,162,0,676,
Babina holsti,213,79,237,188,0,717,
Babina okinavana,224,88,248,181,0,741,
Babina subaspera,206,83,247,181,0,717,
Babylonia areolata,119,101,281,195,0,696,
Bactrocera carambolae,130,75,261,212,0,678,
Bactrocera correcta,134,75,261,208,0,678,
Bactrocera cucurbitae,128,82,264,204,0,678,
Bactrocera dorsalis,131,76,262,208,0,677,
Bactrocera minax,175,86,220,197,0,678,
Bactrocera oleae,151,74,245,208,0,678,
Bactrocera papayae,137,76,256,209,0,678,
Bactrocera philippinensis,134,76,259,209,0,678,
Bactrocera tryoni,145,80,250,203,0,678,
Bagarius yarrelli,200,87,190,207,0,684,
Bahaba taipingensis,262,89,172,161,0,684,
Bahadzia jaraguensis,142,47,273,210,0,672,
Baikalospongia intermedia,107,122,303,203,0,735,
Bajacalifornia megalops,252,97,176,159,0,684,
Balaena mysticetus,211,63,186,221,0,681,
Balaenoptera acutorostrata,195,67,201,218,0,681,
Balaenoptera bonaerensis,205,64,192,220,0,681,
Balaenoptera borealis,192,69,208,212,0,681,
Balaenoptera brydei,193,71,206,211,0,681,
Balaenoptera edeni,198,68,201,214,0,681,
Balaenoptera musculus,194,67,202,218,0,681,
Balaenoptera omurai,198,66,196,221,0,681,
Balaenoptera physalus,194,71,200,216,0,681,
Balanoglossus carnosus,240,108,195,141,0,684,
Balanoglossus clavigerus,236,104,194,156,0,690,
Balanus balanus,113,78,266,206,0,663,
Balearica pavonina,250,65,157,212,0,684,
Balearica regulorum,247,62,157,218,0,684,
Balistapus undulatus,239,83,189,172,0,683,
Balistes vetula,240,82,191,170,0,683,
Balistoides conspicillum,233,85,194,171,0,683,
Bambusicola fytchii,260,66,164,194,0,684,
Bambusicola thoracica,254,66,165,199,0,684,
Bangana decora,180,84,206,214,0,684,
Bangana tungting,183,85,209,207,0,684,
Barbatula barbatula,189,103,198,194,0,684,
Barbatula nuda,188,103,202,191,0,684,
Barbatula toni,194,104,197,189,0,684,
Barbonymus gonionotus,191,93,185,215,0,684,
Barbonymus schwanenfeldii,194,90,178,222,0,684,
Barbourisia rufa,221,84,205,173,0,683,
Barbus barbus,201,91,182,210,0,684,
Barbus trimaculatus,156,94,218,216,0,684,
Barilius bendelisis,203,104,197,179,0,683,
Basiliscus vittatus,209,76,191,207,0,683,
Bassozetus zenkevitchi,214,123,186,160,0,683,
Bathygadus antrodes,140,108,268,167,0,683,
Bathyprion danae,240,103,179,161,0,683,
Bathyteuthis abyssicola,141,64,260,228,0,693,
Bathytroctes breviceps,235,104,177,168,0,684,
Bathytroctes macrolepis,224,95,191,173,0,683,
Bathytroctes michaelsarsi,228,96,191,169,0,684,
Bathytroctes microlepis,210,87,207,179,0,683,
Batocera lineolata,110,59,282,224,0,675,
Batrachoseps attenuatus,155,86,225,218,0,684,
Batrachoseps wrightorum,184,84,211,204,1,684,
Batrachuperus gorganensis,140,77,237,230,0,684,
Batrachuperus londongensis,136,72,245,231,0,684,
Batrachuperus mustersi,140,72,243,229,0,684,
Batrachuperus pinchonii,136,70,246,232,0,684,
Batrachuperus tibetanus,131,72,248,233,0,684,
Batrachuperus yenyuanensis,129,75,254,226,0,684,
Baylisascaris ailuri,39,156,303,102,0,600,
Baylisascaris procyonis,44,151,302,103,0,600,
Baylisascaris schroederi,40,156,301,103,0,600,
Baylisascaris transfuga,45,156,297,102,0,600,
Beatragus hunteri,212,84,174,211,0,681,
Belligobio nummifer,195,95,207,187,0,684,
Bemisia afer,96,118,300,137,0,651,
Bemisia tabaci,90,80,333,148,0,651,
Benedenia hoshinai,71,75,232,132,0,510,
Benedenia seriolae,56,73,252,129,0,510,
Benthodesmus tenuis,223,99,195,166,0,683,
Berardius bairdii,193,69,202,217,0,681,
Berthellina sp.,132,91,242,198,0,663,
Beryx decadactylus,232,89,181,181,0,683,
Beryx mollis,235,96,182,171,0,684,
Beryx splendens,234,95,180,174,0,683,
Betta splendens,157,79,251,197,0,684,
Bhagadatta austenia,89,57,299,233,0,678,
Bidyanus bidyanus,252,93,178,160,0,683,
Bilobella aurantiaca,132,69,280,197,0,678,
Biomphalaria glabrata,95,71,267,207,0,640,
Biomphalaria tenagophila,85,78,299,216,0,678,
Bipes biporus,244,88,147,201,0,680,
Bipes canaliculatus,242,88,157,193,0,680,
Bipes tridactylus,235,78,165,202,0,680,
Bison bison,185,76,192,228,0,681,
Bison bonasus,187,78,194,222,0,681,
Biston panterinaria,95,61,278,244,0,678,
Biston suppressaria,96,58,276,248,0,678,
Biston thibetaria,95,57,279,247,0,678,
Bittacus pilicornis,125,78,273,202,0,678,
Biwia springeri,196,99,210,178,0,683,
Biwia zezera,200,94,204,186,0,684,
Blanus cinereus,214,80,179,208,0,681,
Blarinella quadraticauda,159,71,232,219,0,681,
Blastocerus dichotomus,166,71,215,229,0,681,
Blattella bisignata,101,78,272,230,0,681,
Blattella germanica,113,75,265,228,0,681,
Blicca bjoerkna,188,93,203,200,0,684,
Boa constrictor,185,80,175,240,0,680,
Bolinus brandaris,105,102,317,172,0,696,
Bolitoglossa n.,178,74,213,219,0,684,
Bolocera tuediae,124,143,263,160,0,690,
Bombina fortinuptialis,183,86,226,189,0,684,
Bombina lichuanensis,185,83,225,191,0,684,
Bombina maxima,177,86,232,189,0,684,
Bombina microdeladigitora,189,85,219,191,0,684,
Bombina orientalis,201,83,205,195,0,684,
Bombina variegata,196,86,213,189,0,684,
Bombus hypocrita,69,33,313,263,0,678,
Bombus ignitus,66,33,312,267,0,678,
Bombyx huttoni,90,49,268,271,0,678,
Bombyx mandarina,88,52,277,261,0,678,
Bombyx mori,86,51,277,264,0,678,
Boreogadus saida,180,86,240,177,0,683,
Boreus elegans,91,60,299,228,0,678,
Bos gaurus,181,76,195,229,0,681,
Bos grunniens,182,76,195,228,0,681,
Bos indicus,190,78,188,225,0,681,
Bos javanicus,187,75,190,229,0,681,
Bos mutus,189,75,188,229,0,681,
Bos primigenius,187,75,191,228,0,681,
Bos taurus,187,75,190,229,0,681,
Boselaphus tragocamelus,201,74,189,217,0,681,
Bostockia porosa,191,84,231,177,0,683,
Bostrychus sinensis,241,86,187,170,0,684,
Botaurus stellaris,239,61,170,214,0,684,
Bothriocroton concolor,90,70,300,206,0,666,
Bothriocroton undatum,73,60,323,210,0,666,
Bothriometopus macrocnemis,93,104,278,209,0,684,
Bothropolys sp.,137,62,247,219,0,665,
Bothus pantherinus,237,125,181,140,0,683,
Botrylloides leachii,58,132,287,153,0,630,
Botrylloides nigrum,71,123,282,154,0,630,
Botrylloides pizoni,69,142,296,123,0,630,
Botrylloides violaceus,67,138,287,142,0,634,
Botryllus schlosseri,68,115,304,143,0,630,
Boulengerula boulengeri,152,69,235,228,0,684,
Boulengerula taitana,166,66,219,232,0,683,
Brachaluteres ulvarum,217,87,212,167,0,683,
Brachidontes exustus,97,146,316,188,0,747,
Brachionus plicatilis,130,72,257,151,0,610,
Brachirus orientalis,216,79,203,186,0,684,
Brachycybe lecontii,110,53,270,237,2,672,
Brachyhypopomus occidentalis,238,85,188,173,0,684,
Brachymystax lenok,211,85,208,180,0,684,
Brachymystax lenok,207,87,212,178,0,684,
Brachymystax tumensis,210,86,209,179,0,684,
Brachyphylla cavernarum,202,78,195,206,0,681,
Brachyrhynchus hsiaoi,124,75,240,230,0,669,
Brachythemis contaminata,121,74,248,232,0,675,
Brachyuropus grewingkii,170,79,251,169,0,669,
Bradypus variegatus,226,79,165,211,0,681,
Branchiostegus albus,225,109,182,168,0,684,
Branchiostegus argentatus,215,101,187,181,0,684,
Branchiostegus japonicus,218,102,189,175,0,684,
Branchiostoma belcheri,102,135,256,191,0,684,
Branchiostoma floridae,122,126,260,175,0,683,
Branchiostoma japonicum,103,140,254,187,0,684,
Branchiostoma lanceolatum,119,125,263,177,0,684,
Branta canadensis,253,69,161,201,0,684,
Bregmaceros nectabanus,188,77,244,172,0,681,
Breviceps adspersus,232,58,206,186,0,682,
Brevoortia tyrannus,214,103,192,175,0,684,
Briareum asbestinum,116,117,277,198,0,708,
Brienomyrus niger,223,84,180,196,0,683,
Brontostoma colossus,118,60,225,269,0,672,
Brookesia decaryi,178,61,182,257,0,678,
Brotogeris cyanoptera,266,59,159,200,0,684,
Brugia malayi,44,101,327,110,0,582,
Brycon henni,219,91,201,185,0,696,
Brycon orbignyanus,188,100,206,190,0,684,
Bubalus bubalis,197,80,187,217,0,681,
Bubalus depressicornis,197,81,186,217,0,681,
Bubulcus ibis,251,62,162,209,0,684,
Bucorvus leadbeateri,240,73,165,205,0,683,
Budorcas taxicolor,192,76,193,220,0,681,
Buergeria buergeri,188,78,242,174,0,682,
Bufo gargarizans,221,81,198,184,0,684,
Bufo japonicus,213,88,204,179,0,684,
Bufo melanostictus,208,88,214,174,0,684,
Bufo tibetanus,223,86,195,180,0,684,
Bugula neritina,131,98,243,218,0,690,
Bungarus fasciatus,167,65,213,235,0,680,
Bungarus multicinctus,177,59,205,239,0,680,
Bunocephalus coracoideus,162,89,219,213,0,683,
Bunostomum phlebotomum,31,108,307,154,0,600,
Bunostomum trigonocephalum,36,108,300,156,0,600,
Bursaphelenchus mucronatus,33,68,317,179,0,597,
Bursaphelenchus xylophilus,44,84,304,163,0,595,
Buteo buteo,245,62,171,206,0,684,
Buthus occitanus,61,152,311,142,0,666,
Butorides striata,231,63,173,217,0,684,
Bycanistes brevis,253,71,153,206,0,683,
Cacajao calvus,190,65,205,221,0,681,
Cacatua moluccensis,253,76,172,183,0,684,
Cacopsylla coccinea,147,60,251,217,0,675,
Caecilia gracilis,206,85,192,198,0,681,
Caecilia tentaculata,213,75,191,205,0,684,
Caecilia volcani,215,75,188,206,0,684,
Caenolestes fuliginosus,180,62,214,225,0,681,
Caenorhabditis briggsae,58,93,286,163,0,600,
Caenorhabditis elegans,59,85,276,180,0,600,
Caenorhabditis tropicalis,53,94,294,159,0,600,
Caiman crocodilus,246,52,164,222,0,684,
Cairina moschata,250,96,160,178,0,684,
Calanus hyperboreus,130,129,259,190,0,708,
Calicogorgia granulosa,119,122,279,188,0,708,
Calinaga davidis,82,55,313,228,0,678,
Calisoga longitarsis / Brachythele longitarsis,64,168,302,132,0,666,
Callerebia suroia,95,54,307,222,0,678,
Callicebus cupreus,178,65,220,218,0,681,
Callicebus donacophilus,188,63,210,220,0,681,
Callicebus lugens,182,65,218,216,0,681,
Callimico goeldii,183,68,213,217,0,681,
Callimorpha dominula,84,51,310,233,0,678,
Callinectes sapidus,144,86,262,183,0,675,
Callionymus enneactis,189,112,210,175,0,686,
Calliphora vicina,97,70,293,218,0,678,
Calliptamus italicus,108,66,248,255,0,677,
Callitettix biformis,104,52,218,292,0,666,
Callitettix braconoides,99,60,223,284,0,666,
Callitettix versicolor,111,54,212,289,0,666,
Callithrix geoffroyi,201,69,196,215,0,681,
Callithrix jacchus,205,67,190,219,0,681,
Callithrix pygmaea,200,66,195,220,0,681,
Callorhinchus callorynchus,151,64,254,215,0,684,
Callorhinchus capensis,155,63,250,216,0,684,
Callorhinchus milii,154,61,251,218,0,684,
Callorhinus ursinus,207,76,189,209,0,681,
Callosciurus erythraeus,209,66,193,213,0,681,
Callyspongia plicifera,92,135,313,194,1,735,
Caloglyphus berlesei,104,127,316,125,0,672,
Caloperdix oculeus,241,72,180,191,0,684,
Calosoma sp.,110,62,276,227,0,675,
Calotes versicolor,208,72,179,223,0,682,
Calyptocephallela gayi,232,84,190,178,0,684,
Calyptorhynchus baudinii,244,58,176,206,0,684,
Calyptorhynchus lathami,242,61,173,208,0,684,
Calyptorhynchus latirostris,244,58,176,206,0,684,
Camaena cicatricosa,113,91,271,206,0,681,
Cambaroides similis,87,117,286,185,0,675,
Camelus bactrianus,189,87,195,210,0,681,
Camelus dromedarius,183,85,206,207,0,681,
Camelus ferus,182,85,204,210,0,681,
Campanulotes bidentatus,68,153,318,151,0,690,
Campodea fragilis,139,72,253,211,0,675,
Campodea lubbocki,124,65,279,207,0,675,
Campostoma anomalum,189,103,206,186,0,684,
Campylomormyrus compressirostris,218,94,178,194,0,684,
Campylorhynchus zonatus,269,80,143,192,0,684,
Cancellaria cancellata,86,122,328,160,0,696,
Canis latrans,192,81,209,199,0,681,
Canis lupus,188,82,211,200,0,681,
Canis lupus,189,82,210,199,1,681,
Canis lupus,191,83,209,198,0,681,
Canis lupus,191,83,209,198,0,681,
Canis lupus,189,82,210,200,0,681,
Cantherhines pardalis,233,84,204,163,0,684,
Canthidermis maculata,232,81,189,181,0,683,
Canthigaster coronata,238,84,184,177,0,683,
Canthigaster jactator,235,78,186,184,0,683,
Canthigaster rivulata,232,79,190,182,0,683,
Canthigaster valentini,234,81,194,174,0,683,
Caperea marginata,191,63,201,226,0,681,
Capitulum mitella,153,68,245,200,0,666,
Capra caucasica,203,72,184,222,0,681,
Capra falconeri,200,72,186,218,5,681,
Capra hircus,196,72,191,222,0,681,
Capra ibex,194,70,193,224,0,681,
Capra nubiana,196,72,190,223,0,681,
Capra pyrenaica,195,70,192,224,0,681,
Capra sibirica,193,73,192,219,4,681,
Caprella mutica,150,81,241,200,0,672,
Caprella scaura,133,96,240,202,0,671,
Capreolus capreolus,167,81,223,210,0,681,
Capreolus pygargus,168,81,221,211,0,681,
Capricornis crispus,196,72,189,224,0,681,
Capricornis milneedwardsii,190,71,195,225,0,681,
Capricornis sumatraensis,189,72,195,225,0,681,
Capricornis swinhoei,186,74,199,222,0,681,
Caprimulgus indicus,240,69,160,215,0,684,
Capros aper,193,91,216,183,0,683,
Carangoides armatus,211,87,210,175,0,683,
Carangoides equula,234,98,191,161,0,684,
Carangoides malabaricus,219,95,202,168,0,684,
Caranx ignobilis,207,83,208,180,0,678,
Caranx melampygus,219,85,192,181,0,677,
Carapus bermudensis,228,114,175,166,0,683,
Carassius auratus,176,87,201,220,0,684,
Carassius auratus,172,87,208,217,0,684,
Carassius auratus,172,85,205,222,0,684,
Carassius auratus,173,86,204,221,0,684,
Carassius auratus,174,88,204,218,0,684,
Carassius auratus,173,92,203,216,0,684,
Carassius auratus,173,86,204,221,0,684,
Carassius auratus,170,94,205,215,0,684,
Carassius carassius,173,86,204,221,0,684,
Carassius cuvieri,172,87,208,217,0,684,
Carassius gibelio,175,89,202,218,0,684,
Carcharhinus acronotus,178,67,224,214,0,683,
Carcharhinus amblyrhynchoides,179,68,223,214,0,684,
Carcharhinus amboinensis,172,69,228,215,0,684,
Carcharhinus brevipinna,179,66,221,218,0,684,
Carcharhinus leucas,178,68,223,215,0,684,
Carcharhinus macloti,176,66,225,217,0,684,
Carcharhinus melanopterus,172,70,226,216,0,684,
Carcharhinus obscurus,183,67,217,217,0,684,
Carcharhinus plumbeus,182,69,219,214,0,684,
Carcharhinus sorrah,185,70,214,215,0,684,
Carcharhinus tjutjot,183,69,216,216,0,684,
Carcharias taurus,183,67,220,214,0,684,
Carcharodon carcharias,202,71,207,204,0,684,
Carcinoscorpius rotundicauda,123,46,280,226,0,675,
Cardinalis cardinalis,239,76,174,195,0,684,
Carduelis pinus,242,67,169,206,0,684,
Carduelis psaltria,239,62,172,211,0,684,
Carduelis sinica,242,70,169,203,0,684,
Carduelis spinus,244,67,167,206,0,684,
Caretta caretta,204,53,186,239,0,682,
Caridina gracilipes,155,105,225,190,0,675,
Carinotetraodon lorteti,216,94,194,179,0,683,
Carinotetraodon salivator,217,92,188,186,0,683,
Carios capensis,132,48,278,211,0,669,
Carollia perspicillata,186,80,213,202,0,681,
Carpiodes carpio,183,105,207,189,0,684,
Carpodacus erythrinus,252,80,156,196,0,684,
Carpodacus roseus,236,70,169,209,0,684,
Carposina sasakii,82,51,295,247,0,675,
Carterocephalus silvicola,97,58,292,231,0,678,
Cassiopea frondosa,80,111,306,205,0,702,
Castor canadensis,206,70,185,220,0,681,
Castor fiber,206,64,178,233,0,681,
Casuarius casuarius,233,71,190,190,0,684,
Cataetyx rubrirostris,242,94,187,160,0,683,
Cathartes aura,249,67,168,200,0,684,
Catla catla,200,86,186,212,0,684,
Catopsilia pomona,74,52,313,239,0,678,
Catopuma temminckii,187,81,204,209,0,681,
Catostomus commersonii,173,99,218,194,0,684,
Causus defilippi / Causus defilippii,203,66,213,199,0,681,
Cavariella salicicola,81,33,282,258,0,654,
Cavia porcellus,199,75,199,208,0,681,
Cebus albifrons,198,61,202,220,0,681,
Cebus apella,202,62,197,220,0,681,
Cebus xanthosternos,198,61,201,221,0,681,
Cecropis daurica,245,68,160,211,0,684,
Celaenorrhinus maculosa,99,55,296,228,0,678,
Celastrina hersilia,82,50,299,247,0,678,
Celleporella hyalina,93,94,284,210,1,682,
Centropyge interrupta,218,96,198,172,0,684,
Centropyge loricula,222,103,185,173,0,683,
Centruroides limpidus,73,174,317,102,0,666,
Cepaea nemoralis,141,103,202,113,0,559,
Cephalopholis argus,189,95,205,195,0,684,
Cephalopholis boenak,187,79,205,213,0,684,
Cephalopholis sexmaculata,205,88,196,195,0,684,
Cephalopholis sonnerati,203,80,195,206,0,684,
Cephalophus adersi,190,73,197,221,0,681,
Cephalophus callipygus,202,83,180,216,0,681,
Cephalophus dorsalis,194,75,191,221,0,681,
Cephalophus jentinki,192,72,193,224,0,681,
Cephalophus leucogaster,191,87,194,209,0,681,
Cephalophus natalensis,199,79,190,213,0,681,
Cephalophus nigrifrons,199,83,188,209,2,681,
Cephalophus ogilbyi,205,84,178,214,0,681,
Cephalophus rufilatus,202,83,187,209,0,681,
Cephalophus silvicultor,198,77,185,221,0,681,
Cephalophus spadix,195,77,188,221,0,681,
Cephalorhynchus heavisidii,203,70,196,212,0,681,
Cephalothrix simula,63,95,347,134,0,639,
Cephalothrix sp.,72,88,336,143,0,639,
Cephus cinctus,96,57,261,261,0,675,
Ceracris kiangsu,95,61,253,269,0,678,
Ceracris versicolor,101,60,252,265,0,678,
Ceratias uranoscopus,253,127,173,155,0,708,
Ceratitis capitata,107,78,292,201,0,678,
Ceratotherium simum,214,77,189,201,0,681,
Cercocebus chrysogaster,222,61,174,224,0,681,
Cercocebus torquatus,209,61,184,227,0,681,
Cercopithecus albogularis,218,58,179,226,0,681,
Cercopithecus diana,228,67,167,219,0,681,
Cercopithecus lhoesti,221,58,176,226,0,681,
Cercopithecus mitis,221,62,176,222,0,681,
Cerion incanum,126,99,248,178,0,651,
Cermatobius longicornis,173,76,231,196,0,676,
Cervaphis quercus,76,32,283,263,0,654,
Cervus elaphus,182,78,206,215,0,681,
Cervus elaphus,178,79,209,215,0,681,
Cervus elaphus,175,80,213,213,0,681,
Cervus elaphus,179,80,209,213,0,681,
Cervus nippon,177,76,209,219,0,681,
Cervus nippon,177,76,209,219,0,681,
Cervus nippon,177,78,209,217,0,681,
Cervus nippon,180,81,208,212,0,681,
Cervus nippon,186,77,203,215,0,681,
Cervus nippon,183,79,205,214,0,681,
Cervus nippon,177,77,210,217,0,681,
Ceryle rudis,240,64,169,211,0,684,
Cethosia biblis,104,52,313,209,0,678,
Cetomimus sp.,218,88,206,171,0,683,
Cetorhinus maximus,188,77,216,203,0,684,
Cetostoma regani,197,91,219,176,0,683,
Chabertia erschowi,40,119,276,165,0,600,
Chabertia ovina,41,109,277,170,0,597,
Chaceon granulatus,142,97,262,173,0,674,
Chaenocephalus aceratus,219,103,200,174,0,696,
Chaenogobius gulosus,193,93,226,172,0,684,
Chaenomugil proboscideus,216,80,207,181,0,684,
Chaetoderma nitidulum,172,73,251,203,0,699,
Chaetodermis penicilligerus,218,103,189,173,0,683,
Chaetodon auripes,214,93,213,163,0,683,
Chaetodontoplus conspicillatus,222,91,208,163,0,684,
Chaetodontoplus mesoleucus,223,90,202,168,0,683,
Chaetodontoplus septentrionalis,212,86,216,169,0,683,
Chaetosoma scaritides,89,66,274,240,0,669,
Chaeturichthys stigmatias,207,95,213,169,0,684,
Chalarodon madagascariensis,190,69,210,214,0,683,
Chalceus macrolepidotus,214,80,190,200,0,684,
Chalinolobus tuberculatus,169,83,217,212,0,681,
Challia fletcheri,63,149,321,151,0,684,
Chamaeleo africanus,191,67,177,235,0,670,
Chamaeleo arabicus,192,64,175,243,0,674,
Chamaeleo calcaricarens,195,65,169,241,0,670,
Chamaeleo calyptratus,195,65,174,240,0,674,
Chamaeleo chamaeleon,192,62,173,243,0,670,
Chamaeleo dilepis,184,62,180,249,0,675,
Chamaeleo monachus,195,61,172,242,0,670,
Chamaeleo zeylanicus,200,63,163,244,0,670,
Champsocephalus gunnari,215,97,201,171,0,684,
Champsodon cf.,208,89,218,169,0,684,
Chandlerella quiscali,31,81,346,106,0,564,
Channa argus,245,92,180,167,0,684,
Channa argus,244,92,182,166,0,684,
Channa asiatica,230,84,194,176,0,684,
Channa maculata,243,92,182,167,0,684,
Channa maculata,244,92,182,166,0,684,
Channa marulius,240,86,185,173,0,684,
Chanodichthys dabryi,207,89,186,202,0,684,
Chanodichthys mongolicus,210,89,186,198,0,683,
Chanos chanos,242,99,165,178,0,684,
Charybdis feriata,140,77,273,188,0,678,
Charybdis japonica,145,84,261,185,0,675,
Chauliodus sloani,231,125,193,138,0,687,
Chauliognathus opacus,95,68,264,245,0,672,
Chauliops fallax,117,55,215,276,0,663,
Chaunax abei,205,92,195,191,0,683,
Chaunax pictus,213,94,189,187,0,683,
Chaunax tosaensis,213,90,189,191,0,683,
Cheilinus undulatus,252,82,182,168,0,684,
Cheilochromis euchilus,236,87,195,165,0,683,
Cheilodactylus variegatus,229,96,202,157,0,684,
Cheilodactylus zonatus,221,101,213,148,0,683,
Cheirogaleus medius,194,71,217,199,0,681,
Cheirotonus jansoni,160,83,214,215,0,672,
Chelmon rostratus,182,87,231,184,0,684,
Chelodina longicollis,184,67,195,241,0,687,
Chelodina rugosa,192,58,188,249,0,687,
Chelon labrosus,221,96,198,169,0,684,
Chelonia mydas,219,55,170,239,0,683,
Chelonodon patoca,249,84,177,173,0,683,
Chelonodon pleurospilus,230,85,193,175,0,683,
Chelus fimbriata,189,56,168,232,0,645,
Chelydra serpentina,193,61,190,240,0,684,
Cherax bicarinatus,160,98,250,167,0,675,
Cherax boesemani,154,91,257,173,0,675,
Cherax cainii,149,78,257,191,0,675,
Cherax cairnsensis,161,83,239,192,0,675,
Cherax crassimanus,171,85,228,191,0,675,
Cherax destructor,170,108,219,178,0,675,
Cherax dispar,183,91,219,182,0,675,
Cherax glaber,162,86,239,188,0,675,
Cherax holthuisi,158,99,244,174,0,675,
Cherax monticola,156,89,242,188,0,675,
Cherax preissii,168,89,240,178,0,675,
Cherax quadricarinatus,171,87,243,174,0,675,
Cherax quinquecarinatus,170,96,224,185,0,675,
Cherax robustus,164,82,242,187,0,675,
Cherax tenuimanus,153,79,256,187,0,675,
Chikila fulleri,156,53,240,235,0,684,
Chilo auricilius,80,51,296,251,0,678,
Chilo suppressalis,93,52,289,247,0,681,
Chilodus punctatus,179,81,221,202,0,683,
Chilomycterus reticulatus,242,85,186,170,0,683,
Chiloscyllium griseum,161,68,234,221,0,684,
Chiloscyllium plagiosum,185,73,212,214,0,684,
Chiloscyllium punctatum,163,64,233,224,0,684,
Chimaera fulva,201,69,211,203,0,684,
Chimaera monstrosa,183,71,233,197,0,684,
Chinchilla lanigera,217,80,176,208,0,681,
Chinemys reevesi / Mauremys reevesii,197,70,185,232,0,684,
Chionodraco myersi,212,109,202,161,0,684,
Chirocentrus dorab,237,110,183,153,0,683,
Chironomus tepperi,107,71,298,202,0,678,
Chiropotes albinasus,202,70,196,213,0,681,
Chiropotes israelita,185,66,214,216,0,681,
Chirostoma humboldtianum,231,97,191,165,0,684,
Chitala blanci,209,77,184,213,0,683,
Chitala lopis,209,78,187,209,0,683,
Chitala ornata,200,76,197,210,0,683,
Chitoria ulupi,97,56,293,232,0,678,
Chitra indica,208,58,170,248,0,684,
Chlamydosaurus kingii,211,44,181,248,0,684,
Chlamydoselachus anguineus,155,73,261,195,0,684,
Chlamys farreri,90,225,308,166,0,789,
Chlorocebus aethiops,221,64,176,220,0,681,
Chlorocebus cynosuros,221,69,175,216,0,681,
Chlorocebus pygerythrus,221,68,175,217,0,681,
Chlorocebus sabaeus,223,65,174,219,0,681,
Chlorocebus tantalus,229,67,169,216,0,681,
Chlorophanes spiza,238,65,174,202,5,684,
Chlorophthalmus agassizi,214,101,206,163,0,684,
Chlorurus sordidus,219,104,196,164,0,683,
Choaspes benjaminii,104,54,301,219,0,678,
Choerodon schoenleinii,225,91,183,185,0,684,
Choloepus didactylus,218,82,171,210,0,681,
Chondracris rosea,116,69,251,254,0,690,
Chondrilla aff.,90,137,309,199,0,735,
Chondrostoma lemmingii,191,112,201,180,0,684,
Choristoneura longicellana,86,60,297,235,0,678,
Chorthippus chinensis,97,66,252,263,0,678,
Chroicocephalus ridibundus,257,69,160,198,0,684,
Chromobotia macracanthus,187,95,196,206,0,684,
Chromodoris magnifica,117,103,255,188,0,663,
Chrysaora quinquecirrha,103,119,296,190,0,708,
Chrysemys picta,205,72,182,225,0,684,
Chrysemys picta,206,73,181,224,0,684,
Chrysochir aureus,236,89,196,163,0,684,
Chrysochloris asiatica,180,70,215,216,0,681,
Chrysochroa fulgidissima,135,79,225,236,0,675,
Chrysocyon brachyurus,184,77,220,200,0,681,
Chrysolampis mosquitus,245,76,165,198,0,684,
Chrysolophus amherstiae,238,66,187,193,0,684,
Chrysolophus pictus,240,66,185,193,0,684,
Chrysomus cyanopus,253,73,156,202,0,684,
Chrysomus icterocephalus,243,73,164,204,0,684,
Chrysomus ruficapillus,245,73,161,205,0,684,
Chrysomus thilius,242,72,163,207,0,684,
Chrysomus xanthophthalmus,251,73,158,202,0,684,
Chrysomya albiceps,106,68,277,227,0,678,
Chrysomya bezziana,111,71,273,223,0,678,
Chrysomya megacephala,100,76,288,214,0,678,
Chrysomya pinguis,102,76,284,216,0,678,
Chrysomya putoria,103,74,285,216,0,678,
Chrysomya rufifacies,104,68,283,223,0,678,
Chrysomya saffranea,99,75,289,215,0,678,
Chrysopa pallens,85,71,290,232,0,678,
Chrysopathes formosa,116,139,277,182,0,714,
Chrysoperla nipponensis,82,73,294,229,0,678,
Chthamalus antennatus,110,84,284,188,0,666,
Chthonerpeton indistinctum,193,66,205,220,0,684,
Ciconia boyciana,241,70,165,208,0,684,
Ciconia ciconia,243,71,164,206,0,684,
Ciconia nigra,250,71,160,203,0,684,
Cinachyrella kuekenthali,87,137,298,204,0,726,
Ciona savignyi,61,83,310,176,0,630,
Cipangopaludina cathayensis,70,109,331,171,0,681,
Cirrhigaleus australis,168,70,228,191,0,657,
Cirrhinus molitorella,186,84,197,217,0,684,
Cirrhinus mrigala,201,88,187,208,0,684,
Cirrhinus mrigala,194,93,185,215,0,687,
Cirrhitichthys aprinus,193,101,225,164,0,683,
Cistopus taiwanicus,120,55,311,219,0,705,
Citharinus congicus,227,90,181,185,0,683,
Citharoides macrolepidotus,240,97,182,180,0,699,
Clarias batrachus,202,77,186,218,0,683,
Clarias fuscus,209,74,186,215,0,684,
Clathrina clathrus,243,78,248,193,0,762,
Clava multicornis,85,94,303,223,0,705,
Clavelina lepadiformis,70,73,330,151,0,624,
Clavelina phlegraea,65,64,319,176,0,624,
Clibanarius infraspinatus,132,98,244,201,0,675,
Clinocottus analis,268,92,169,153,0,682,
Clinostomum complanatum,57,121,248,87,0,513,
Clonorchis sinensis,64,136,248,68,0,516,
Clupanodon thrissa,219,109,184,171,0,683,
Clupea harengus,212,103,199,171,0,685,
Clupea pallasii,213,102,198,170,0,683,
Clupeichthys aesarnensis,215,89,203,177,0,684,
Clupeichthys goniognathus,216,95,206,167,0,684,
Clupeichthys perakensis,218,88,198,180,0,684,
Clupeoides borneensis,225,83,182,194,0,684,
Clupeoides sp.,204,80,205,195,0,684,
Clupeonella cultriventris,204,107,203,170,0,684,
Clymenella torquata,147,86,246,218,0,697,
Cnaphalocrocis medinalis,81,56,312,226,0,675,
Cnemaspis limi,245,77,170,189,0,681,
Cnemotriccus fuscatus,225,68,197,194,0,684,
Cobitis choii,179,98,220,187,0,684,
Cobitis elongatoides,177,98,219,190,0,684,
Cobitis granoei,170,94,226,194,0,684,
Cobitis lutheri,167,102,224,191,0,684,
Cobitis sinensis,182,95,207,197,0,681,
Cobitis striata,184,102,208,190,0,684,
Cobitis takatsuensis,177,99,220,188,0,684,
Coccothraustes coccothraustes,231,70,174,209,0,684,
Cochliomyia hominivorax,101,70,276,231,0,678,
Coelodonta antiquitatis,208,71,189,213,0,681,
Coelomactra antiquata,82,168,305,190,0,745,
Coelophrys brevicaudata,209,101,217,156,0,683,
Coelorinchus kishinouyei,206,81,223,173,0,683,
Coendou insidiosus,171,72,224,214,0,681,
Coilia grayii,195,83,205,201,0,684,
Coilia lindmani,199,88,196,201,0,684,
Coilia mystus,194,89,208,193,0,684,
Coilia nasus,191,81,211,200,0,683,
Coilia reynaldi,197,91,188,208,0,684,
Coleonyx variegatus,217,71,197,195,0,680,
Colinus virginianus,251,65,174,194,0,684,
Colisa fasciata,186,85,229,184,0,684,
Colisa lalia,182,87,225,189,0,683,
Colistium nudipinnis,212,98,214,160,0,684,
Colletes gigas,50,39,325,258,0,672,
Collichthys lucidus,242,82,187,173,0,684,
Collichthys niveatus,249,90,182,163,0,684,
Colobus guereza,209,69,189,214,0,681,
Coloceras sp.,63,171,297,147,15,693,
Coloconger cadenati,210,91,194,188,0,683,
Cololabis saira,204,77,218,184,0,683,
Colomesus asellus,231,82,196,174,0,683,
Colomesus psittacus,231,85,192,175,0,683,
Colossoma macropomum,225,88,186,185,0,684,
Colpophyllia natans,90,123,321,144,0,678,
Columba livia,240,67,181,196,0,684,
Concholepas concholepas,129,127,290,150,0,696,
Conger japonicus,177,86,224,197,0,684,
Conger myriaster,183,85,219,197,0,684,
Connochaetes gnou,203,81,180,217,0,681,
Connochaetes taurinus,199,79,183,220,0,681,
Conocara macropterum,212,91,198,182,0,683,
Conocara murrayi,219,85,196,183,0,683,
Conocephalus maculatus,136,79,257,201,0,673,
Contracaecum osculatum,47,123,307,123,0,600,
Contracaecum rudolphii,49,146,289,116,0,600,
Conus borgesi,105,114,319,158,0,696,
Conus consors,108,115,308,165,0,696,
Conus textile,127,105,296,168,0,696,
Cooperia oncophora,33,101,295,167,4,600,
Coptodon zillii,241,94,183,166,0,684,
Coptosoma bifaria,118,90,220,256,0,684,
Coptotermes formosanus,154,76,178,273,0,681,
Coptotermes lacteus,178,73,157,273,0,681,
Corallianassa coutierei,95,154,292,132,0,673,
Corallimorphus profundus,93,153,292,161,0,699,
Corallium elatius,114,127,269,198,0,708,
Corallium konojoi,114,127,269,198,0,708,
Corallium rubrum,113,124,270,201,0,708,
Corcyra cephalonica,98,52,303,228,0,681,
Coreana raphaelis,74,51,306,246,0,677,
Coregonus clupeaformis,229,98,186,171,0,684,
Coregonus lavaretus,226,99,188,171,0,684,
Coregonus nasus,228,99,186,171,0,684,
Coregonus oxyrinchus,226,98,188,172,0,684,
Coregonus peled,226,98,188,172,0,684,
Coregonus ussuriensis,226,98,188,172,0,684,
Coreius guichenoti,181,93,212,198,0,684,
Coreius heterodon,175,83,217,209,0,684,
Coreoleuciscus splendidus,174,95,223,192,0,684,
Coreoperca herzi,229,95,198,162,0,684,
Coreoperca kawamebari,210,86,221,166,0,683,
Coreoperca loona,235,89,187,173,0,684,
Coreoperca whiteheadi,217,90,203,173,0,683,
Corticium candelabrum,104,131,297,212,0,744,
Corvus brachyrhynchos,233,65,166,220,0,684,
Corvus cornix,0,0,0,0,684,684,
Corvus hawaiiensis,232,74,168,210,0,684,
Corvus macrorhynchos,231,69,174,210,0,684,
Corvus splendens,231,73,171,209,0,684,
Corydalus cornutus,133,68,276,198,0,675,
Corydoras rabauti,186,84,192,222,0,684,
Corynactis californica,102,154,281,162,0,699,
Corythucha ciliata,92,54,230,283,0,659,
Cosmoscarta bispecularis,83,59,262,262,0,666,
Cotesia vestalis,44,47,367,211,0,669,
Cottus czerskii,238,93,193,160,0,684,
Cottus dzungaricus,234,90,199,161,0,684,
Cottus hangiongensis,234,96,196,158,0,684,
Cottus poecilopus,235,102,193,154,0,684,
Cottus reinii,232,93,196,162,0,683,
Coturnicops exquisitus,227,64,168,225,0,684,
Coturnix chinensis,246,67,174,197,0,684,
Coturnix japonica,250,64,167,203,0,684,
Cramptonomyia spenceri,114,67,278,219,0,678,
Cranoglanis bouderius,199,80,188,217,0,684,
Craspedacusta sowerbyi,160,154,260,131,0,705,
Crassostrea angulata,100,147,249,188,0,684,
Crassostrea ariakensis,91,142,254,188,0,675,
Crassostrea gigas,101,147,252,193,0,693,
Crassostrea hongkongensis,84,134,267,199,0,684,
Crassostrea iredalei,82,131,269,202,0,684,
Crassostrea nippona,91,133,262,207,0,693,
Crassostrea sikamea,90,136,265,193,0,684,
Crassostrea sp.,93,136,262,193,0,684,
Crassostrea virginica,122,140,233,180,0,675,
Crax daubentoni,248,70,167,199,0,684,
Crax rubra,250,69,165,200,0,684,
Crenimugil crenilabis,243,82,181,178,0,684,
Creteuchiloglanis kamengensis,215,84,166,219,0,684,
Cricetulus griseus,162,73,219,227,0,681,
Cricetulus kamensis,210,75,182,214,0,681,
Cricetulus longicaudatus,166,75,219,221,0,681,
Crioceris duodecimpunctata,111,62,263,239,0,675,
Cristaria plicata,69,185,298,150,0,702,
Crocidura attenuata,159,72,233,217,0,681,
Crocidura russula,168,79,227,207,0,681,
Crocidura shantungensis,158,69,239,215,0,681,
Crocodylus acutus,216,82,175,223,0,696,
Crocodylus intermedius,214,83,176,223,0,696,
Crocodylus johnsoni,228,80,163,225,0,696,
Crocodylus mindorensis,209,75,173,227,0,684,
Crocodylus moreletii,218,87,173,218,0,696,
Crocodylus niloticus,215,84,170,215,0,684,
Crocodylus novaeguineae,213,85,173,225,0,696,
Crocodylus palustris,211,84,169,220,0,684,
Crocodylus porosus,216,77,168,223,0,684,
Crocodylus rhombifer,213,96,177,210,0,696,
Crocodylus siamensis,219,80,172,225,0,696,
Crocuta crocuta,212,91,177,201,0,681,
Cromeria occidentalis,195,94,204,190,0,683,
Cromileptes altivelis,207,77,194,206,0,684,
Crossoptilon auritum,245,72,181,186,0,684,
Crossoptilon crossoptilon,245,72,182,185,0,684,
Crossoptilon harmani,244,72,183,185,0,684,
Crossoptilon mantchuricum,244,72,182,186,0,684,
Crossorhombus azureus,215,100,192,177,0,684,
Crossorhombus kobensis,215,122,196,150,0,683,
Crotalus horridus,204,67,181,229,0,681,
Crotaphatrema lamottei,179,68,210,227,0,684,
Cryptocellus narino,148,55,210,259,0,672,
Cryptocercus relictus,111,73,209,288,0,681,
Cryptochiton stelleri,85,136,312,163,0,696,
Cryptopsaras couesii,219,113,186,172,0,690,
Cryptopygus antarcticus,130,90,244,217,0,681,
Ctenomys leucodon,160,69,232,220,0,681,
Ctenomys sociabilis,155,65,240,221,0,681,
Ctenopharyngodon idella,198,90,195,201,0,684,
Ctenopharyngodon idella,180,87,212,205,0,684,
Ctenopharyngodon idella,180,87,212,205,0,684,
Ctenopharyngodon idellus,180,88,212,204,0,684,
Ctenoplusia agnata,82,56,318,222,0,678,
Ctenoplusia limbirena,85,57,318,218,0,678,
Ctenoptilum vasava,95,60,301,222,0,678,
Cubaia aphrodite,101,108,304,192,0,705,
Cubiceps pauciradiatus,203,94,204,182,0,683,
Cubitermes ugandensis,145,77,190,266,0,678,
Cucujus clavipes,114,59,278,221,0,672,
Cucullanus robustus,47,131,309,113,0,600,
Cucumaria miniata,169,74,216,225,0,684,
Culaea inconstans,191,88,223,182,0,684,
Culex pipiens,102,71,284,224,0,681,
Culex quinquefasciatus,101,75,285,220,0,681,
Culicoides arakawae,118,68,276,210,0,672,
Culter alburnus,206,95,187,196,0,684,
Culter alburnus,206,95,187,195,0,683,
Culter erythropterus,200,94,195,195,0,684,
Culter recurviceps,203,96,190,195,0,684,
Cultrichthys compressocorpus,198,92,199,195,0,684,
Cuneopsis pisciculus,76,178,309,139,0,702,
Cuon alpinus,178,89,224,190,0,681,
Cuora amboinensis,198,64,189,233,0,684,
Cuora aurocapitata,188,72,198,226,0,684,
Cuora bourreti,192,75,199,230,0,696,
Cuora flavomarginata,183,68,203,230,0,684,
Cuora galbinifrons,184,70,207,235,0,696,
Cuora pani,188,72,198,226,0,684,
Cuora picturata,189,66,201,240,0,696,
Cuora trifasciata,187,69,198,230,0,684,
Cupido argiades,81,53,298,246,0,678,
Curaeus curaeus,245,72,166,201,0,684,
Curetis bulis,80,55,321,222,0,678,
Curimata mivartii,198,81,208,197,0,684,
Cyanopica cyanus,229,76,167,212,0,684,
Cyanoplax caverna,97,80,302,226,0,705,
Cyanoptila cyanomelana,241,73,167,203,0,684,
Cyclemys atripons,184,68,198,234,0,684,
Cyclemys dentata,181,73,200,230,0,684,
Cyclemys fusca,191,68,196,229,0,684,
Cyclemys oldhamii,199,69,185,231,0,684,
Cyclemys pulchristriata,183,67,199,235,0,684,
Cyclemys tcheponensis,200,70,184,233,0,687,
Cycleptus elongatus,176,101,214,193,0,684,
Cyclocheilichthys enoplos,187,91,188,218,0,684,
Cyclograpsus granulosus,141,77,266,191,0,675,
Cyclopsetta fimbriata,220,105,189,169,0,683,
Cyclura pinguis,219,68,186,211,0,684,
Cydia pomonella,91,61,299,227,0,678,
Cydistomyia duplonotata,99,73,282,221,0,675,
Cyema atrum,195,98,189,202,0,684,
Cygnus atratus,253,79,160,192,0,684,
Cygnus columbianus,245,77,170,192,0,684,
Cygnus columbianus,242,75,172,195,0,684,
Cygnus cygnus,238,78,177,191,0,684,
Cygnus olor,242,89,169,184,0,684,
Cylicocyclus insignis,38,109,284,169,0,600,
Cylindrophis ruffus,194,63,188,235,0,680,
Cylindrus obtusus,172,111,224,145,0,652,
Cymatium parthenopeum,118,93,302,183,0,696,
Cymatogaster aggregata,212,90,213,168,0,683,
Cymbium olla,107,97,299,190,0,693,
Cynoglossus abbreviatus,206,69,215,194,0,684,
Cynoglossus bilineatus,194,77,198,215,0,684,
Cynoglossus itinus,188,79,218,199,0,684,
Cynoglossus lineolatus,205,69,216,194,0,684,
Cynoglossus puncticeps,184,80,234,186,0,684,
Cynoglossus semilaevis,206,68,212,197,0,683,
Cynoglossus sinicus,195,76,212,201,0,684,
Cynoglossus trigrammus,206,74,198,206,0,684,
Cynomys leucurus,171,75,230,205,0,681,
Cynomys ludovicianus,173,79,228,204,0,684,
Cynoponticus ferox,191,85,210,197,0,683,
Cynopterus brachyotis,212,75,184,210,0,681,
Cynotilapia afra,243,88,189,163,0,683,
Cyphomyrus discorhynchus,223,97,174,190,0,684,
Cyphon sp.,114,78,258,225,0,675,
Cyprinella lutrensis,181,96,217,190,0,684,
Cyprinella spiloptera,192,105,212,175,0,684,
Cyprinodon rubrofluviatilis,231,86,204,163,0,684,
Cyprinus carpio,189,92,190,212,0,683,
Cyprinus carpio,193,91,186,214,0,684,
Cyprinus carpio,189,91,190,214,0,684,
Cyprinus carpio,193,90,187,214,0,684,
Cyprinus carpio,191,91,188,214,0,684,
Cyprinus carpio,191,90,188,215,0,684,
Cyprinus carpio,191,90,188,215,0,684,
Cyprinus carpio,189,91,190,214,0,684,
Cyprinus carpio,193,91,187,213,0,684,
Cypselurus hiraii,207,84,208,184,1,684,
Cyrestis thyodamas,89,55,288,246,0,678,
Cystophora cristata,213,75,184,209,0,681,
Daboia russellii / Daboia russelii,190,64,207,220,0,681,
Dactylopsila trivirgata,182,69,204,226,0,681,
Dactyloptena orientalis,217,99,190,177,0,683,
Dactyloptena peterseni,229,94,182,178,0,683,
Dactyloptena tiltoni,231,101,184,167,0,683,
Dahurinaia dahurica,87,196,305,120,0,708,
Daimio tethys,103,59,296,220,0,678,
Dallia pectoralis,206,90,230,156,0,682,
Dama dama,172,77,215,217,0,681,
Dama mesopotamica,178,81,208,214,0,681,
Damaliscus lunatus,210,87,175,209,0,681,
Damaliscus pygargus,208,90,178,205,0,681,
Damaster mirabilissimus,105,61,273,239,0,678,
Damithrax spinosissimus,141,71,275,188,0,675,
Damon diadema,181,65,224,202,0,672,
Danacetichthys galathenus,191,93,229,170,0,683,
Danaus chrysippus,87,49,304,241,0,681,
Danaus plexippus,80,50,311,240,0,681,
Danio dangila,170,80,224,209,0,683,
Danio rerio,187,83,215,199,0,684,
Daphnia magna,143,102,265,165,0,675,
Daphnia pulex,166,119,240,150,0,675,
Darthula hardwickii,95,57,228,268,0,648,
Dascillus cervinus,132,81,236,220,0,669,
Dastarcus helophoroides,95,66,277,231,0,669,
Dasyatis akajei,204,70,209,201,0,684,
Dasyatis bennetti,205,71,208,200,0,684,
Dasyatis zugei,171,60,237,216,0,684,
Dasypus novemcinctus,198,73,175,235,0,681,
Dasyurus hallucatus,176,61,235,209,0,681,
Daubentonia madagascariensis,215,66,185,215,0,681,
Davidius lunatus,138,87,221,231,0,677,
Decapterus macarellus,235,93,189,167,0,684,
Decapterus macrosoma,240,96,184,164,0,684,
Decapterus maruadsi,235,94,188,167,0,684,
Deinagkistrodon acutus,217,72,173,218,0,680,
Delias hyparete,85,51,304,238,0,678,
Delphinus capensis,189,69,209,214,0,681,
Demodex brevis,193,25,164,281,0,663,
Demodex folliculorum,167,35,207,251,0,660,
Dendrocygna javanica,236,80,167,201,0,684,
Dendrohyrax dorsalis,217,71,165,228,0,681,
Dendrolimus punctatus,99,57,286,236,0,678,
Dendrolimus spectabilis,91,54,292,241,0,678,
Dendrolimus tabulaeformis,99,55,286,238,0,678,
Dendronephthya castanea,116,120,273,199,0,708,
Dendronephthya gigantea,117,120,273,198,0,708,
Dendronephthya mollis,116,120,273,199,0,708,
Dendronephthya suensoni,114,120,275,199,0,708,
Dendrophyllia cribrosa,96,150,293,160,0,699,
Dendrophysa russelii,229,83,194,178,0,684,
Dendropoma gregarium,129,149,266,146,0,690,
Dendropoma maximum,107,158,297,126,0,688,
Denticeps clupeoides,182,77,226,198,0,683,
Deracantha onos,164,77,258,194,0,693,
Derichthys serpentinus,211,94,189,189,0,683,
Dermacentor nitens,90,63,322,191,0,666,
Dermacentor silvarum,88,60,306,212,0,666,
Dermatobia hominis,105,64,270,239,0,678,
Dermatophagoides farinae,79,119,346,138,0,682,
Dermatophagoides pteronyssinus,78,118,321,158,0,675,
Dermophis mexicanus,148,59,234,243,0,684,
Desmodus rotundus,222,97,171,191,0,681,
Desmognathus fuscus,133,59,256,236,0,684,
Desmognathus wrighti,146,66,247,225,0,684,
Devario chrysotaeniatus,185,89,196,214,0,684,
Devario laoensis,183,97,196,208,0,684,
Diabrotica barberi,99,68,264,244,0,675,
Diadegma semiclausum,66,41,311,256,0,674,
Diagramma picta,236,94,179,174,0,683,
Diaphus splendidus,245,96,182,161,0,684,
Diatraea saccharalis,91,52,288,250,0,681,
Dicentrarchus labrax,225,97,199,163,0,684,
Dicentrarchus punctatus,241,109,180,154,0,684,
Diceratias pileatus,220,95,187,181,0,683,
Dicerorhinus sumatrensis,202,80,198,201,0,681,
Diceros bicornis,208,70,195,208,0,681,
Dichocrocis punctiferalis,97,59,307,209,0,672,
Dichorragia nesimachus,80,56,305,237,0,678,
Dicrocoelium chinensis,51,137,261,64,0,513,
Dicrocoelium dendriticum,55,139,251,68,0,513,
Dictyocaulus eckerti,31,100,341,113,0,585,
Dictyocaulus viviparus,33,99,340,128,0,600,
Didelphis virginiana,158,61,231,231,0,681,
Didemnum vexillum,52,35,283,197,0,567,
Dimidiochromis compressiceps,238,88,193,164,0,683,
Dinocras cephalotes,198,86,217,177,0,678,
Dinodon semicarinatus,189,65,178,249,0,681,
Dinornis giganteus,252,67,176,189,0,684,
Diodon holocanthus,237,83,197,166,0,683,
Diphyllobothrium latum,67,97,243,103,0,510,
Diphyllobothrium nihonkaiense,74,93,234,109,0,510,
Diplacanthopoma brachysoma,266,83,172,162,0,683,
Diplogonoporus balaenopterae,65,97,254,94,0,510,
Diplogonoporus grandis,65,97,254,94,0,510,
Diploid megalobrama,201,92,194,197,0,684,
Diploid xenocypris,200,91,196,197,0,684,
Diplometopon zarudnyi,196,66,195,223,0,680,
Diplomystes nahuelbutaensis,201,85,190,207,0,683,
Diplophos taenia,242,120,191,131,0,684,
Diploprion bifasciatum,206,99,191,188,0,684,
Diplosoma listerianum,63,47,293,178,0,581,
Diplotaxodon limnothrissa,238,87,196,162,0,683,
Dipturus kwangtungensis,204,73,206,201,0,684,
Diptychus maculatus,175,112,216,181,0,684,
Dipylidium caninum,47,91,279,99,0,516,
Diretmoides veriginae,250,98,168,167,0,683,
Diretmus argenteus,243,96,180,164,0,683,
Dirofilaria immitis,38,124,344,70,0,576,
Discoglossus galganoi,200,96,215,172,0,683,
Discogobio tetrabarbatus,181,86,204,213,0,684,
Discogobio yunnanensis,173,84,210,217,0,684,
Discosoma nummiforme,93,149,292,165,0,699,
Discosoma sp.,94,150,290,165,0,699,
Discosoma sp.,94,150,290,165,0,699,
Dissostichus eleginoides,221,115,203,157,0,696,
Distichodus sexfasciatus,205,74,194,211,0,684,
Distoechodon tumirostris,203,88,190,203,0,684,
Distoechurus pennatus,190,59,210,222,0,681,
Ditaxis biseriata,98,66,276,238,0,678,
Ditrema temminckii,189,87,227,180,0,683,
Diuraphis noxia,74,33,292,248,0,647,
Dives dives,246,63,163,212,0,684,
Doederleinia berycoides,212,90,214,167,0,683,
Dogania subplana,195,59,180,250,0,684,
Doliolum nationalis,130,115,224,138,0,607,
Dolycoris baccarum,111,79,239,258,0,687,
Dophla evelina,84,51,307,236,0,678,
Dorcatragus megalotis,171,65,222,223,0,681,
Dorosoma cepedianum,217,100,192,174,0,683,
Dorosoma petenense,216,97,196,174,0,683,
Doryrhamphus japonicus,223,95,189,176,0,683,
Doryteuthis opalescens,156,65,258,214,0,693,
Dosidicus gigas,146,66,266,215,0,693,
Draconetta xenica,185,77,228,194,0,684,
Dracunculus medinensis,27,132,313,104,0,576,
Dremomys rufigenis,197,68,200,216,0,681,
Drepane longimana,236,92,190,166,0,684,
Drepane punctata,236,93,190,165,0,684,
Drepanotermes sp.,147,77,196,261,0,681,
Dromaius novaehollandiae,234,66,186,198,0,684,
Dromiciops gliroides,187,64,208,222,0,681,
Drosophila incompta,96,79,285,221,0,681,
Drosophila littoralis,121,73,269,212,0,675,
Drosophila mauritiana,94,71,295,214,0,674,
Drosophila melanogaster,94,68,295,218,0,675,
Drosophila pseudoobscura,99,69,284,223,0,675,
Drosophila santomea,95,69,297,214,0,675,
Drosophila sechellia,100,68,288,218,0,674,
Drosophila simulans,98,71,290,215,0,674,
Drosophila yakuba,95,68,297,215,0,675,
Dryocopus pileatus,272,86,160,166,0,684,
Dugesia japonica,56,108,371,101,0,636,
Dugong dugon,204,89,200,188,0,681,
Dupetor flavicollis,229,60,180,215,0,684,
Dysalotus alcocki,190,110,209,174,0,683,
Dysdercus cingulatus,97,60,256,253,0,666,
Dysmicohermes ingens,97,71,294,216,0,678,
Echeneis naucrates,182,80,223,198,0,683,
Echinocardium cordatum,152,114,237,193,0,696,
Echinococcus canadensis,37,121,271,84,0,513,
Echinococcus equinus,38,121,266,88,0,513,
Echinococcus felidis,40,116,269,88,0,513,
Echinococcus granulosus,39,125,268,81,0,513,
Echinococcus multilocularis,39,117,271,89,0,516,
Echinococcus oligarthrus,41,110,268,94,0,513,
Echinococcus ortleppi,44,120,265,84,0,513,
Echinococcus shiquicus,35,118,266,94,0,513,
Echinococcus vogeli,38,124,274,77,0,513,
Echinogorgia complexa,112,120,280,196,0,708,
Echinops telfairi,174,68,236,203,0,681,
Echinorhynchus truttae,77,163,232,107,0,579,
Echinosorex gymnura,146,63,245,227,0,681,
Echinotriton andersoni,190,79,195,220,0,684,
Echymipera rufescens,164,63,230,224,0,681,
Ectyoplasia ferox,84,117,326,208,0,735,
Egretta eulophotes,256,67,155,206,0,684,
Egretta garzetta,252,68,158,206,0,684,
Egretta sacra,252,63,159,210,0,684,
Ehirava fluviatilis,197,86,210,191,0,684,
Eigenmannia sp.,223,87,194,180,0,684,
Elaphe bimaculata,184,71,188,238,0,681,
Elaphe davidi,179,66,192,244,0,681,
Elaphe poryphyracea,191,66,181,243,0,681,
Elaphodus cephalophus,169,83,216,213,0,681,
Elaphurus davidianus,179,82,211,209,0,681,
Elassoma evergladei,191,85,220,188,0,684,
Elassoma zonatum,190,88,217,189,0,684,
Eleotris acanthopoma,208,98,185,192,0,683,
Eleotris oxycephala,210,88,201,184,0,683,
Elephantulus sp.,184,81,209,207,0,681,
Elephas maximus,183,83,201,202,0,669,
Eleutheronema tetradactylum,224,107,189,164,0,684,
Elimaea cheni,124,76,267,208,0,675,
Ellipes minuta,166,84,235,190,0,675,
Elodia flavipalpis,85,62,292,239,0,678,
Elophila interruptalis,84,54,301,239,0,678,
Elopichthys bambusa,181,103,214,186,0,684,
Elops hawaiensis,220,109,175,179,0,683,
Elops saurus,220,110,175,178,0,683,
Elseya branderhorsti,204,69,173,241,0,687,
Elymnias hypermnestra,80,54,319,225,0,678,
Elysia chlorotica,141,112,227,180,0,660,
Emberiza aureola,245,77,162,200,0,684,
Emberiza chrysophrys,253,73,155,203,0,684,
Emberiza cioides,256,72,156,200,0,684,
Emberiza pusilla,248,77,164,195,0,684,
Emberiza rustica,244,77,166,197,0,684,
Emberiza rutila,245,77,162,200,0,684,
Emberiza spodocephala,251,72,158,203,0,684,
Emberiza tristrami,247,70,162,205,0,684,
Emeus crassus,257,59,170,198,0,684,
Emmelichthys struhsakeri,226,91,193,174,0,684,
Emplectonema gracile,91,138,330,123,0,682,
Empoasca vitis,71,75,296,212,0,654,
Emydura subglobosa,190,62,190,245,0,687,
Engaeus cunicularius,154,79,252,190,0,675,
Engaeus lengana,163,78,261,179,0,681,
Engaeus lyelli,196,80,218,181,0,675,
Engaeus quadrimanus,177,75,232,191,0,675,
Engaeus sericatus,175,73,233,194,0,675,
Engraulis encrasicolus,194,104,215,170,0,683,
Engraulis japonicus,193,108,216,167,0,684,
Enhydra lutris,194,79,198,210,0,681,
Enhydris plumbea,196,62,182,239,0,679,
Enithares tibialis,98,67,221,281,0,667,
Enophrys diceraus,230,95,198,161,0,684,
Enoplometopus debelius,120,77,277,201,0,675,
Enoplometopus occidentalis,121,76,279,199,0,675,
Ensatina eschscholtzii,151,70,234,229,0,684,
Enterobius vermicularis,47,142,328,120,0,637,
Entoria okinawaensis,91,69,249,266,0,675,
Eogystia hippophaecolus,108,61,281,228,0,678,
Eophreatoicus sp.,73,130,291,175,0,669,
Eopsaltria australis,239,72,173,200,0,684,
Eospalax baileyi,178,66,216,221,0,681,
Eospalax cansus,175,66,220,220,0,681,
Eospalax rothschildi,173,63,224,221,0,681,
Eothenomys chinensis,211,73,189,208,0,681,
Epacanthaclisis banksi,118,72,266,222,0,678,
Ephemera orientalis,141,76,258,202,0,677,
Ephestia kuehniella,91,57,317,216,0,681,
Ephydatia muelleri,106,121,303,204,1,735,
Epigonichthys cultellus,118,139,250,177,0,684,
Epigonichthys maldivensis,133,147,249,154,0,683,
Epinephelus akaara,194,87,213,190,0,684,
Epinephelus areolatus,206,90,202,186,0,684,
Epinephelus awoara,206,87,202,189,0,684,
Epinephelus bleekeri,209,88,203,184,0,684,
Epinephelus bruneus,212,86,194,192,0,684,
Epinephelus coioides,210,87,202,185,0,684,
Epinephelus coioides,211,87,201,185,0,684,
Epinephelus corallicola,206,85,200,193,0,684,
Epinephelus epistictus,197,90,209,188,0,684,
Epinephelus fasciatomaculosus,191,90,214,189,0,684,
Epinephelus fuscoguttatus,206,86,201,191,0,684,
Epinephelus lanceolatus,212,86,199,187,0,684,
Epinephelus latifasciatus,203,88,208,185,0,684,
Epinephelus merra,211,91,195,186,0,683,
Epinephelus moara,212,86,195,191,0,684,
Epinephelus quoyanus,201,85,208,190,0,684,
Epinephelus septemfasciatus,199,91,202,192,0,684,
Epinephelus sexfasciatus,204,93,204,183,0,684,
Epinephelus stictus,204,90,202,188,0,684,
Epinephelus trimaculatus,206,91,202,185,0,684,
Epinephelus tukula,215,95,195,179,0,684,
Epinnula magistralis,215,87,197,184,0,683,
Epiophlebia superstes,104,74,233,218,48,677,
Epiperipatus biolleyi,59,116,313,190,0,678,
Episoriculus caudatus,177,75,213,216,0,681,
Episoriculus fumidus,182,72,208,219,0,681,
Eptatretus burgeri,155,56,263,213,0,687,
Eptesicus serotinus,176,86,215,204,0,681,
Epthianura albifrons,236,70,166,212,0,684,
Equus asinus,205,74,185,217,0,681,
Equus burchellii,207,71,187,216,0,681,
Equus caballus,214,81,176,210,0,681,
Equus grevyi,203,75,189,214,0,681,
Equus hemionus,206,77,185,213,0,681,
Equus hemionus,205,74,186,216,0,681,
Equus kiang,206,74,185,216,0,681,
Equus ovodovi,201,78,190,212,0,681,
Equus przewalskii,213,79,177,212,0,681,
Equus zebra,205,77,187,212,0,681,
Equus zebra,204,77,188,212,0,681,
Eremias argus,204,83,199,195,0,681,
Eremias brenchleyi,215,85,186,195,0,681,
Eremias multiocellata,208,85,196,192,0,681,
Eremias przewalskii,198,83,205,195,0,681,
Eremias vermiculata,210,74,197,200,0,681,
Eremitalpa granti,177,72,225,207,0,681,
Eremobates cf.,150,61,232,232,0,675,
Eremopsaltria mongolica,243,77,156,208,0,684,
Eretmochelys imbricata,209,56,180,238,0,683,
Erianthus versicolor,99,64,227,288,0,678,
Erignathus barbatus,202,74,196,209,0,681,
Erilepis zonifer,213,100,200,171,0,684,
Erimyzon oblongus,171,99,218,195,0,683,
Erinaceus europaeus,151,68,240,222,0,681,
Eriocheir hepuensis,127,81,265,202,0,675,
Eriocheir japonica,126,80,268,201,0,675,
Eriocheir sinensis,131,81,264,199,0,675,
Eriogyna pyretorum,85,53,325,215,0,678,
Erpetoichthys calabaricus,161,70,221,191,0,643,
Erpobdella octoculata,147,84,270,201,0,702,
Erynnis montanus,81,54,312,231,0,678,
Erythrocebus patas,214,66,184,217,0,681,
Escarpia spicata,175,68,260,184,0,687,
Eschrichtius robustus,205,66,192,218,0,681,
Escualosa thoracata,226,120,196,142,0,684,
Esomus metallicus,174,97,199,214,0,684,
Esox lucius,217,96,212,157,0,682,
Esox reichertii,215,81,214,172,0,682,
Etheostoma radiosum,209,98,213,164,0,684,
Ethmalosa fimbriata,209,100,200,174,0,683,
Ethmidium maculatum,215,98,188,183,0,684,
Etroplus maculatus,242,89,189,164,0,684,
Etrumeus teres,197,93,208,185,0,683,
Eualetes tulipa,117,149,258,161,0,685,
Euastacus armatus,166,70,251,188,0,675,
Euastacus spinifer,157,77,256,185,0,675,
Euastacus yarraensis,167,73,248,187,0,675,
Eubalaena australis,203,65,192,221,0,681,
Eubalaena japonica,200,64,194,223,0,681,
Eubalichthys mosaicus,218,104,210,151,0,683,
Eubasilissa regina,128,63,260,227,0,678,
Euchiloglanis kishinouyei,199,86,179,219,0,683,
Euchorthippus fusigeniculatus,104,59,254,261,0,678,
Eucryptorhynchus brandti,114,54,282,222,0,672,
Eucryptorrhynchus chinensis,107,51,284,230,0,672,
Eudontomyzon morii,180,67,217,215,0,679,
Eudorcas rufifrons,185,76,197,223,0,681,
Eudromia elegans,244,59,194,187,0,684,
Eudynamys taitensis,242,68,174,200,0,684,
Eudyptes chrysocome,253,63,158,210,0,684,
Eudyptula minor,254,67,158,205,0,684,
Eulabeornis castaneoventris,247,68,170,199,0,684,
Eulemur fulvus,190,74,218,199,0,681,
Eulemur fulvus,190,74,218,199,0,681,
Eulemur macaco,189,70,220,202,0,681,
Eulemur mongoz,188,67,220,206,0,681,
Eulemur rubriventer,183,75,225,198,0,681,
Eulemur rufus,193,73,214,201,0,681,
Eulimnogammarus verrucosus,143,68,263,195,0,669,
Eulimnogammarus vittatus,137,77,266,189,0,669,
Eumegistus illustris,238,81,184,180,0,683,
Eumetopias jubatus,212,72,185,212,0,681,
Eunapius subterraneus,106,122,303,204,0,735,
Euphaea decorata,130,79,220,246,0,675,
Euphaea formosa,127,75,223,250,0,675,
Euphaea ornata,127,75,220,253,0,675,
Euphaea yayeyamana,125,75,225,250,0,675,
Euphagus cyanocephalus,244,68,164,208,0,684,
Euphausia pacifica,115,88,264,208,0,675,
Euphlyctis hexadactylus,221,75,217,169,0,682,
Euphyllia ancora,98,161,286,154,0,699,
Euplexaura crassa,119,117,272,200,0,708,
Euploea core,74,49,314,241,0,678,
Euploea midamus,91,50,297,240,0,678,
Euploea mulciber,79,49,313,237,0,678,
Eupolyphaga sinensis,110,69,257,245,0,681,
Euprepiophis perlacea,193,71,171,246,0,681,
Euproctis pseudoconspersa,103,56,293,226,0,678,
Eurema hecabe,84,51,308,235,0,678,
Euripus nyctelius,99,58,282,239,0,678,
Eurycea bislineata,163,71,233,217,0,684,
Eurypegasus draconis,190,87,204,202,0,683,
Eurypharynx pelecanoides,185,101,202,195,0,683,
Eurytrema pancreaticum,62,119,271,67,0,519,
Euseius nicholsi,114,42,265,244,1,666,
Euspilotus scissus,118,70,261,229,0,678,
Eusthenes cupreus,94,90,263,264,0,711,
Eutaeniophorus festivus,216,82,207,178,0,683,
Eutaeniophorus sp.,196,91,220,176,0,683,
Eutelia adulatricoides,87,58,305,228,0,678,
Euthalia irrubescens,81,54,316,227,0,678,
Euthynnus affinis,225,93,182,184,0,684,
Euthynnus alletteratus,223,96,183,181,0,683,
Evania appendigaster,134,42,300,199,0,675,
Evoxymetopon poeyi,232,83,200,168,0,683,
Exocoetus volitans,209,95,203,176,0,683,
Exopalaemon carinicauda,185,92,217,181,0,675,
Exorista sorbillans,100,63,286,229,0,678,
Exostoma labiatum,220,72,170,222,0,684,
Extatosoma tiaratum,106,60,220,286,0,672,
Fabriciana nerippe,90,52,305,231,0,678,
Facciolella oxyrhyncha,177,87,201,218,0,683,
Falco cherrug,246,64,169,205,0,684,
Falco columbarius,262,62,156,204,0,684,
Falco peregrinus,250,63,165,206,0,684,
Falco sparverius,257,65,159,203,0,684,
Falco tinnunculus,253,64,163,204,0,684,
Farfantepenaeus californiensis,151,94,247,183,0,675,
Fasciola gigantica,47,144,270,58,0,519,
Fasciola hepatica,57,133,265,64,0,519,
Fejervarya cancrivora,195,89,224,174,0,682,
Fejervarya limnocharis,202,81,203,196,0,682,
Felis catus,190,79,204,208,0,681,
Fenneropenaeus chinensis,145,86,256,188,0,675,
Fenneropenaeus merguiensis,144,92,243,196,0,675,
Fenneropenaeus penicillatus,148,92,239,196,0,675,
Feresa attenuata,199,65,200,217,0,681,
Fergusonina taylori,102,66,270,240,0,678,
Ficedula albicollis,271,81,151,190,0,693,
Ficedula zanthopygia,247,74,157,206,0,684,
Filchnerella beicki,118,65,242,253,0,678,
Filchnerella helanshanensis,114,66,246,252,0,678,
Fissurella volcano,94,197,269,136,0,696,
Fistularia commersonii,227,97,193,166,0,683,
Fistularia petimba,231,90,189,173,0,683,
Florometra serratissima,84,94,361,154,0,693,
Flustra foliacea,84,153,299,145,0,681,
Flustrellidra hispida,176,102,192,151,0,621,
Folsomotoma octooculata,111,77,260,236,0,684,
Formica fusca,89,43,313,224,0,669,
Formica selysi,89,44,313,223,0,669,
Formosania lacustris,198,102,204,180,0,684,
Francolinus pintadeanus,244,69,175,196,0,684,
Frankliniella intonsa,103,66,278,249,0,696,
Friesea grisea,143,67,263,208,0,681,
Fringilla coelebs,258,65,156,205,0,684,
Fringilla montifringilla,254,64,159,207,0,684,
Fruhstorferiola kulinga,102,63,257,256,0,678,
Fulica atra,258,61,158,207,0,684,
Fulvia mutica,104,191,331,193,0,819,
Fundulus diaphanus,171,82,249,182,0,684,
Fundulus grandis,165,87,244,188,0,684,
Fundulus heteroclitus,162,84,251,187,0,684,
Fundulus olivaceus,190,81,233,179,0,683,
Fungiacyathus stephanus,97,154,294,154,0,699,
Furcifer oustaleti,188,63,177,250,0,678,
Fusiturris similis,113,109,302,175,0,699,
Gabala argentata,84,53,312,229,0,678,
Gadopsis bispinosus,173,78,229,203,0,683,
Gadopsis marmoratus,174,77,224,209,0,684,
Gadus chalcogrammus,186,86,232,180,0,684,
Gadus morhua,175,85,244,180,0,684,
Gadus ogac,180,83,241,180,0,684,
Gagata dolichonema,196,81,187,220,0,684,
Galago moholi,207,67,197,210,0,681,
Galago senegalensis,207,67,196,211,0,681,
Galathealinum brachiosum,96,45,308,241,0,690,
Galaxias gollumoides,206,110,216,152,0,684,
Galaxias maculatus,192,125,230,136,0,683,
Galaxias sp.,209,118,215,142,0,684,
Galaxiella nigrostriata,168,88,232,195,0,683,
Galba pervia,92,82,310,203,0,687,
Galemys pyrenaicus,181,69,203,227,0,680,
Galeocerdo cuvier,162,64,236,222,0,684,
Galeopterus variegatus,222,64,181,214,0,681,
Galeruca daurica,99,63,276,237,0,675,
Gallinula chloropus,246,61,170,207,0,684,
Gallirallus okinawae,261,59,158,206,0,684,
Gallirallus philippensis,267,64,150,203,0,684,
Gallus gallus,264,69,154,197,0,684,
Gallus gallus,264,69,154,197,0,684,
Gallus gallus,264,70,154,196,0,684,
Gallus gallus,264,71,154,195,0,684,
Gallus lafayetii,261,68,158,197,0,684,
Gallus sonneratii,258,64,160,202,0,684,
Gallus varius,263,68,156,197,0,684,
Gambelia wislizenii,207,70,186,220,0,683,
Gambusia affinis,223,91,199,170,0,683,
Gammarus duebeni,170,89,238,175,0,672,
Gampsocleis gratiosa,177,82,225,189,0,673,
Gandalfus yunohana,134,78,273,190,0,675,
Garra flavatra,171,83,215,214,0,683,
Garra imberba,187,97,198,202,0,684,
Garra orientalis,187,93,202,202,0,684,
Garra rufa,177,97,211,198,0,683,
Garra spilota,184,91,206,202,0,683,
Garrulax canorus,260,69,162,193,0,684,
Garrulax cineraceus,265,66,159,194,0,684,
Garrulax perspicillatus,252,76,165,191,0,684,
Garrulus glandarius,224,64,181,215,0,684,
Gasterochisma melampus,241,95,179,169,0,684,
Gasterosteus aculeatus,196,94,219,174,0,683,
Gasterosteus wheatlandi,185,93,220,186,0,684,
Gastrimargus marmoratus,109,61,237,271,0,678,
Gastrocopta cristata,103,90,284,171,0,648,
Gavia pacifica,253,67,161,202,1,684,
Gavia stellata,255,66,156,207,0,684,
Gavialis gangeticus,202,72,190,231,0,695,
Gazella bennettii,181,70,203,227,0,681,
Gazella cuvieri,184,75,200,222,0,681,
Gazella dorcas,187,76,198,219,1,681,
Gazella erlangeri,180,71,204,226,0,681,
Gazella gazella,179,70,205,227,0,681,
Gazella leptoceros,184,75,200,222,0,681,
Gazella spekei,186,77,199,219,0,681,
Gazella subgutturosa,183,70,201,227,0,681,
Gegeneophis ramaswamii,152,59,227,245,0,683,
Geisha distinctissima,117,56,191,288,0,652,
Gekko chinensis,174,70,206,231,0,681,
Gekko gecko,208,71,192,216,0,687,
Gekko swinhonis,199,72,195,215,0,681,
Gekko vittatus,162,69,219,230,0,680,
Genetta servalina,172,71,220,218,0,681,
Genyochromis mento,242,88,190,163,0,683,
Genyomyrus donnyi,223,88,174,199,0,684,
Geocalamus acutus,195,81,198,206,0,680,
Geocharax gracilis,150,85,237,203,0,675,
Geococcyx californianus,243,60,164,217,0,684,
Geocoris pallidipennis,96,74,227,266,0,663,
Geodia neptuni,87,127,303,217,1,735,
Geothelphusa dehaani,120,69,277,206,0,672,
Geotrygon violacea,244,62,165,212,0,683,
Geotrypetes seraphini,149,69,249,217,0,684,
Gigantactis vanhoeffeni,246,104,180,153,0,683,
Gila conspersa,185,111,202,186,0,684,
Gila robusta,189,107,198,190,0,684,
Gillichthys seta,212,91,216,162,0,681,
Giraffa camelopardalis,190,75,196,220,0,681,
Giraffa camelopardalis,192,75,192,222,0,681,
Girella punctata,197,93,224,169,0,683,
Glandirana tientaiensis,232,76,216,158,0,682,
Glaridoglanis andersonii,214,78,172,220,0,684,
Glis glis,157,73,235,214,0,679,
Globicephala macrorhynchus,196,68,202,215,0,681,
Globicephala melas,196,69,202,214,0,681,
Glossanodon semifasciatus,216,88,219,160,0,683,
Glossogobius circumspectus,225,104,192,163,0,684,
Glossogobius olivaceus,225,105,191,163,0,684,
Gloydius blomhoffi,210,71,197,203,0,681,
Gloydius intermedius,220,71,184,206,0,681,
Gloydius saxatilis,225,70,178,208,0,681,
Gloydius ussuriensis,210,73,190,208,0,681,
Glyphis garricki,181,65,221,217,0,684,
Glyphis glyphis,176,65,224,219,0,684,
Glyphodes pyloalis,86,59,308,222,0,675,
Glyphodes quadrimaculalis,85,57,310,223,0,675,
Glyptosternon maculatum,200,83,191,210,0,684,
Glyptothorax fokiensis,188,76,195,225,0,684,
Glyptothorax sinensis,190,83,192,219,0,684,
Glyptothorax trilineatus,204,86,181,213,0,684,
Gnathonemus petersii,215,93,181,194,0,683,
Gnathopogon elongatus,179,103,220,182,0,684,
Gnathopogon polytaenia,180,106,212,186,0,684,
Gnathopogon strigatus,186,101,207,189,0,683,
Gnathostomula armata,55,59,284,169,0,567,
Gnathostomula paradoxa,126,61,256,208,0,651,
Gnorimopsar chopi,250,70,163,201,0,684,
Gobio gobio,185,94,213,192,0,684,
Gobiobotia brevibarba,204,103,199,178,0,684,
Gobiobotia intermedia,204,106,209,165,0,684,
Gobiobotia macrocephala,209,103,192,180,0,684,
Gobiobotia naktongensis,193,95,211,185,0,684,
Gobiocypris rarus,179,91,220,194,0,684,
Gomphiocephalus hodgsoni,117,78,286,200,0,681,
Gomphocerippus rufus,101,64,251,262,0,678,
Gomphocerus licenti,94,61,258,265,0,678,
Gomphocerus sibiricus,95,62,257,264,0,678,
Gomphocerus sibiricus,108,61,254,255,0,678,
Gondogeneia antarctica,146,76,258,192,0,672,
Gonepteryx mahaguru,79,49,313,237,0,678,
Gonepteryx rhamni,79,50,313,236,0,678,
Gongylonema pulchrum,34,87,323,121,0,565,
Goniada japonica,154,62,259,224,0,699,
Goniopora columna,104,154,285,156,0,699,
Goniurosaurus luii,197,55,200,229,0,681,
Gonodactylus chiragra,152,83,237,206,0,678,
Gononemertes parasita,76,131,386,100,0,693,
Gonorynchus abbreviatus,213,115,202,154,0,684,
Gonorynchus greyi,229,121,191,143,0,684,
Gorilla gorilla,228,76,172,205,0,681,
Gorilla gorilla,229,75,172,205,0,681,
Gorpis annulatus,93,64,264,248,0,669,
Gorpis humeralis,118,70,247,249,0,684,
Gracula religiosa,246,75,166,197,0,684,
Gramastacus lacus,159,79,250,187,0,675,
Grammistes sexlineatus,230,87,168,199,0,684,
Grampus griseus,190,68,208,215,0,681,
Grandisonia sechellensis,174,61,226,223,0,684,
Graphium chironides,88,55,315,220,0,678,
Graphium timur,93,58,294,233,0,678,
Grapholita dimorpha,87,67,298,226,0,678,
Grapholita molesta,82,67,301,228,0,678,
Graptacme eborea,91,85,292,209,1,678,
Grasseichthys gabonensis,194,84,200,205,0,683,
Grundulus bogotensis,172,92,229,190,0,683,
Grus americana,237,65,171,211,0,684,
Grus antigone,236,62,173,213,0,684,
Grus canadensis,237,65,173,209,0,684,
Grus carunculatus,233,65,176,210,0,684,
Grus grus,233,64,176,211,0,684,
Grus japonensis,235,62,175,212,0,684,
Grus leucogeranus,236,63,173,212,0,684,
Grus monacha,243,68,167,206,0,684,
Grus nigricollis,242,67,168,207,0,684,
Grus rubicunda,237,62,172,213,0,684,
Grus vipio,234,64,175,211,0,684,
Gryllotalpa orientalis,135,65,273,204,0,677,
Gryllotalpa pluvialis,138,66,269,202,0,675,
Gudusia chapra,200,82,200,202,0,684,
Gulo gulo,195,83,205,198,0,681,
Gymnarchus niloticus,197,77,193,216,0,683,
Gymnocephalus cernua,222,94,209,159,0,684,
Gymnocypris eckloni,167,99,222,196,0,684,
Gymnocypris przewalskii,167,98,222,197,0,684,
Gymnocypris przewalskii,167,98,222,197,0,684,
Gymnodiptychus pachycheilus,175,105,214,190,0,684,
Gymnogobius petschiliensis,194,93,230,167,0,684,
Gymnomystax mexicanus,250,67,158,209,0,684,
Gymnopis multiplicata,152,59,219,254,0,684,
Gymnosarda unicolor,244,90,178,172,0,684,
Gymnothorax kidako,200,100,218,165,0,683,
Gymnura poecilura,233,84,194,173,0,684,
Gynaephora menyuanensis,85,49,296,248,0,678,
Gyrinocheilus aymonieri,192,93,194,205,0,684,
Gyrinomimus myersi,222,85,200,176,0,683,
Gyrinomimus sp.,219,87,202,175,0,683,
Gyrinophilus porphyriticus,180,71,218,215,0,684,
Gyrodactylus derjavinoides,77,76,202,158,0,513,
Gyrodactylus salaris,101,101,174,137,0,513,
Gyrodactylus thymalli,99,101,176,137,0,513,
Habronattus oregonensis,64,110,294,192,0,660,
Hackeriella veitchi,144,63,237,222,0,666,
Haemaphysalis flava,92,66,314,194,0,666,
Haemaphysalis formosensis,86,63,316,201,0,666,
Haemaphysalis parva,83,54,313,216,0,666,
Haematobia irritans,91,69,295,223,0,678,
Haematopus ater,247,64,166,207,0,684,
Haemonchus contortus,35,103,283,179,0,600,
Haemorhous cassinii,231,73,174,206,0,684,
Haemorhous mexicanus,239,67,163,215,0,684,
Halichoeres melanurus,196,91,217,179,0,683,
Halichoeres tenuispinis,202,99,214,169,0,684,
Halichoeres trimaculatus,233,79,189,182,0,683,
Halichoerus grypus,209,77,191,204,0,681,
Halicryptus spinulosus,89,123,297,166,0,675,
Haliotis laevigata,189,86,174,151,0,600,
Haliotis rubra,210,100,207,179,0,696,
Haliotis tuberculata,196,95,214,191,0,696,
Halisarca dujardini,107,144,302,182,0,735,
Halisarca sp.,89,139,315,192,0,735,
Halocaridina rubra,165,97,222,191,0,675,
Halocynthia roretzi,47,140,299,150,0,636,
Halocynthia spinosa,49,191,298,101,0,639,
Halyomorpha halys,92,65,247,271,0,675,
Hamadryas epinome,81,54,310,233,0,678,
Hapalemur griseus,181,68,230,202,0,681,
Hapalogenys analis,257,88,168,171,0,684,
Hapalogenys nigripinnis,208,94,214,168,0,684,
Haplophryne mollis,193,96,207,187,0,683,
Haplorchis taichui,58,140,237,81,0,516,
Harengula jaguana,212,125,194,153,0,684,
Harpadon microchir,218,87,220,159,0,684,
Harpadon nehereus,223,88,209,164,0,684,
Harpiosquilla harpax,121,88,271,198,0,678,
Harriotta raleighana,221,85,199,179,0,684,
Hasemania nana,196,89,205,194,0,684,
Hasora vitta,102,58,295,223,0,678,
Hebomoia glaucippe,85,53,310,230,0,678,
Helarctos malayanus,189,99,207,186,0,681,
Heleophryne regis,210,74,214,184,0,682,
Helicolenus avius,213,93,201,176,0,683,
Helicolenus hilgendorfi,214,92,200,177,0,683,
Heliconema longissimum,46,82,329,122,0,579,
Heliconius cydno,83,54,313,228,0,678,
Heliconius hecale,90,52,310,226,0,678,
Heliconius ismenius,91,54,304,229,0,678,
Heliconius pachinus,81,54,315,228,0,678,
Heliconius sara,85,55,304,234,0,678,
Helicoverpa armigera,86,56,300,236,0,678,
Helicoverpa assulta,86,56,300,236,0,678,
Helicoverpa punctigera,84,56,295,243,0,678,
Heliocidaris crassispina,183,97,208,202,0,690,
Heliopora coerulea,112,115,273,204,4,708,
Heliornis fulica,219,78,183,204,0,684,
Helix aspersa,123,70,266,189,0,648,
Heloderma suspectum,158,67,220,238,0,683,
Helostoma temminkii,230,83,188,182,0,683,
Hemibagrus guttatus,169,73,208,234,0,684,
Hemibagrus macropterus,171,73,208,232,0,684,
Hemibagrus nemurus,125,64,147,171,0,507,
Hemibagrus spilopterus,184,81,195,224,0,684,
Hemibagrus wyckioides,172,80,206,226,0,684,
Hemibarbus barbus,194,100,210,180,0,684,
Hemibarbus labeo,193,101,211,179,0,684,
Hemibarbus longirostris,189,103,209,183,0,684,
Hemibarbus maculatus,195,99,211,179,0,684,
Hemibarbus medius,196,99,209,179,0,683,
Hemibarbus mylodon,178,99,223,184,0,684,
Hemibarbus umbrifer,200,97,205,181,0,683,
Hemicentrotus pulcherrimus,155,114,236,185,0,690,
Hemiculter leucisculus,204,89,196,195,0,684,
Hemiculterella sauvagei,198,96,202,188,0,684,
Hemidactylium scutatum,150,76,235,220,0,681,
Hemidactylus frenatus,236,90,158,196,0,680,
Hemiechinus auritus,137,62,251,231,0,681,
Hemignathus flavus,237,71,167,209,0,684,
Hemignathus munroi,244,65,161,214,0,684,
Hemignathus parvus,242,66,161,215,0,684,
Hemignathus stejnegeri,240,70,165,209,0,684,
Hemigrammocypris rasborella,191,92,200,200,0,683,
Hemiodoecus leai,148,67,223,228,0,666,
Hemiodopsis gracilis,214,91,186,192,0,683,
Hemiphaga novaeseelandiae,236,63,176,209,0,684,
Hemipyrellia ligurriens,106,69,285,218,0,678,
Hemisus marmoratus,196,67,233,183,0,679,
Hemitheconyx caudicinctus,230,95,166,189,0,680,
Hemitragus jayakari,194,74,191,222,0,681,
Hemitragus jemlahicus,198,73,188,222,0,681,
Hemitriakis japanica,187,74,216,207,0,684,
Henicorhina leucosticta,247,70,169,198,0,684,
Henicorhynchus lineatus,171,83,215,214,0,683,
Heniochus diphreutes,222,88,188,185,0,683,
Henosepilachna pusillanima,90,65,298,219,0,672,
Heosemys depressa,191,67,192,234,0,684,
Hepsetus odoe,225,99,179,180,0,683,
Heptathela hangzhouensis / Songthela hangzhouensis,113,63,272,213,0,661,
Heptranchias perlo,166,65,248,205,0,684,
Herdmania momus,63,170,286,109,2,630,
Herpele squalostoma,184,73,218,209,0,684,
Herpestes javanicus,190,77,198,216,0,681,
Herwigia kreffti,230,92,184,178,0,684,
Hesperiphona vespertina,249,65,159,211,0,684,
Heterocephalus glaber,225,62,165,229,0,681,
Heteroconger hassi,204,99,189,191,0,683,
Heterodontus francisci,178,69,222,215,0,684,
Heterodontus zebra,178,70,218,218,0,684,
Heterodoxus macropus,62,77,303,215,0,657,
Heteromycteris japonicus,211,85,208,180,0,684,
Heteronotia binoei,239,70,164,207,0,680,
Heteropneustes fossilis,199,72,182,230,0,683,
Heteropteryx dilatata,95,62,230,285,0,672,
Heterorhabditis bacteriophora,48,94,294,161,0,597,
Heterotermes sp.,164,73,170,274,0,681,
Heterotilapia buttikoferi,232,89,196,167,0,684,
Heterotis niloticus,198,82,210,194,0,684,
Hexagrammos agrammus,230,94,192,167,0,683,
Hexagrammos lagocephalus,230,96,193,165,0,684,
Hexagrammos otakii,232,92,190,170,0,684,
Hexamermis agrotis,65,51,236,176,0,528,
Hexanchus griseus,167,69,251,197,0,684,
Hexanchus nakamurai,173,68,240,203,0,684,
Hexaprotodon liberiensis,213,79,169,220,0,681,
Hiatella arctica,98,158,344,183,0,783,
Himantolophus albinares,218,102,186,177,0,683,
Himantolophus groenlandicus,224,101,181,177,0,683,
Himantura gerrardi,203,94,215,172,0,684,
Himantura granulata,186,70,230,198,0,684,
Himantura microphthalma,196,67,215,206,0,684,
Himatione sanguinea,239,72,168,205,0,684,
Hiodon alosoides,197,84,203,199,0,683,
Hiodon tergisus,186,81,212,205,0,684,
Hipparchia autonoe,108,58,291,221,0,678,
Hippocamelus antisensis,173,71,213,224,0,681,
Hippocampus barbouri,168,74,226,216,0,684,
Hippocampus comes,171,75,226,212,0,684,
Hippocampus erectus,187,81,213,203,0,684,
Hippocampus histrix,176,78,221,208,0,683,
Hippocampus ingens,174,73,231,206,0,684,
Hippocampus kuda,177,74,222,210,0,683,
Hippocampus trimaculatus,177,72,222,213,0,684,
Hippoglossus hippoglossus,222,98,199,164,0,683,
Hippoglossus stenolepis,224,96,198,165,0,683,
Hippopotamus amphibius,221,80,161,219,0,681,
Hipposideros armiger,203,78,198,202,0,681,
Hippospongia lachne,72,197,291,148,0,708,
Hippotragus equinus,188,74,198,221,0,681,
Hippotragus niger,188,75,201,217,0,681,
Hirudo nipponia,103,111,284,214,0,712,
Histiopterus typus,221,96,192,174,0,683,
Holacanthus clarionensis,219,99,196,170,0,684,
Holothuria forskali,156,98,229,201,0,684,
Holothuria scabra,180,98,192,214,0,684,
Homalodisca vitripennis,81,64,272,237,0,654,
Homaloptera leonardi,198,92,201,193,0,684,
Homarus americanus,132,95,258,189,0,674,
Homarus gammarus,128,102,267,178,0,675,
Homatula potanini,187,95,202,200,0,684,
Homatula variegatus,186,101,205,192,0,684,
Homo heidelbergensis,214,67,165,197,38,681,
Homo sapiens,230,71,174,206,0,681,
Homo sapiens,227,73,177,204,0,681,
Homo sp.,227,74,177,203,0,681,
Homologenus malayensis,143,70,259,200,0,672,
Hongeo koreana,221,76,195,192,0,684,
Hoplobatrachus rugulosus,242,84,191,165,0,682,
Hoplobatrachus tigerinus,224,76,203,179,0,682,
Hoplolatilus cuniculus,202,99,210,172,0,683,
Hoplostethus japonicus,209,88,216,170,0,683,
Hoplunnis punctata,188,86,195,214,0,683,
Horadandia atukorali,169,89,217,208,0,683,
Hormathia digitata,116,144,269,161,0,690,
Howella brodiei,212,86,215,170,0,683,
Hucho bleekeri,218,80,205,181,0,684,
Hucho hucho,217,85,205,177,0,684,
Hucho taimen,216,83,206,179,0,684,
Humphaplotropis culaishanensis,121,66,243,248,0,678,
Huso dauricus,232,93,175,184,0,684,
Huso huso,236,100,171,177,0,684,
Hutchinsoniella macracantha,60,157,324,137,0,678,
Hyaena hyaena,204,91,186,200,0,681,
Hyattella sinuosa,67,188,301,152,0,708,
Hydaropsis longirostris,110,62,256,244,0,672,
Hydatigera krepkogorski,47,87,255,130,0,519,
Hydatigera parva,40,107,253,116,0,516,
Hydra magnipapillata,82,68,348,204,0,702,
Hydra oligactis,85,69,338,209,1,702,
Hydra sinensis,69,67,354,215,0,705,
Hydrobasileus croceus,109,70,251,245,0,675,
Hydrolagus lemures,207,67,207,203,0,684,
Hydrolycus scomberoides,227,91,192,173,0,683,
Hydromantes brunus,134,66,263,221,0,684,
Hydrometra greeni,93,52,246,273,0,664,
Hydropotes inermis,168,79,221,213,0,681,
Hydropotes inermis,168,81,221,211,0,681,
Hydrosaurus amboinensis,218,56,160,248,0,682,
Hydroscapha granulum,97,77,278,226,0,678,
Hydrurga leptonyx,199,69,203,210,0,681,
Hyemoschus aquaticus,187,82,201,211,0,681,
Hyla annectans,198,82,221,183,0,684,
Hyla chinensis,213,73,210,188,0,684,
Hyla japonica,194,70,241,178,0,683,
Hyla tsinlingensis,211,78,223,172,0,684,
Hylaeus dilatatus,68,37,304,269,0,678,
Hylarana guentheri,206,77,229,164,0,676,
Hyliota flavigaster,227,72,171,214,0,684,
Hylobates agilis,237,76,164,204,0,681,
Hylobates lar,237,73,164,207,0,681,
Hylobates pileatus,241,78,162,200,0,681,
Hylobitelus xiaoi,125,58,277,215,0,675,
Hylomys suillus,173,66,239,203,0,681,
Hylopetes phayrei,187,70,213,211,0,681,
Hymeniacidon sinapium,91,140,298,206,0,735,
Hymenochirus boettgeri,196,82,205,201,0,684,
Hymenolepis diminuta,53,88,253,122,0,516,
Hynobius amjiensis,148,74,243,219,0,684,
Hynobius arisanensis,135,68,251,230,0,684,
Hynobius chinensis,153,72,236,223,0,684,
Hynobius formosanus,137,63,253,231,0,684,
Hynobius guabangshanensis,153,72,236,223,0,684,
Hynobius kimurae,131,75,258,220,0,684,
Hynobius leechii,135,67,252,230,0,684,
Hynobius maoershanensis,154,74,235,221,0,684,
Hynobius nebulosus,151,79,236,218,0,684,
Hynobius nigrescens,147,72,242,223,0,684,
Hynobius quelpaertensis,136,77,251,220,0,684,
Hynobius yangi,136,68,250,230,0,684,
Hynobius yiwuensis,145,76,247,216,0,684,
Hypentelium nigricans,172,103,212,197,0,684,
Hyperlophus vittatus,203,100,213,168,0,684,
Hyperoglyphe japonica,226,106,192,159,0,683,
Hyperolius marmoratus,154,67,254,207,0,682,
Hyperoodon ampullatus,194,64,201,222,0,681,
Hyphantria cunea,94,55,290,239,0,678,
Hypoatherina tsurugae,220,92,209,162,0,683,
Hypochilus thorelli,73,126,303,164,0,666,
Hypoderma lineatum,108,67,279,224,0,678,
Hypodontus macropi,40,130,296,131,0,597,
Hypogeophis rostratus,176,70,216,222,0,684,
Hypolimnas bolina,94,57,284,243,0,678,
Hypomesus nipponensis,214,106,217,147,0,684,
Hypomesus olidus,214,104,217,149,0,684,
Hypophthalmichthys molitrix,198,89,195,202,0,684,
Hypophthalmichthys nobilis,197,93,196,198,0,684,
Hypoplectrus gemma,194,99,224,166,0,683,
Hypoptychus dybowskii,203,102,230,148,0,683,
Hyporhamphus intermedius,208,83,226,167,0,684,
Hyporhamphus sajori,210,84,231,159,0,684,
Hyporthodus octofasciatus,198,85,208,193,0,684,
Hypostomus plecostomus,206,81,196,201,0,684,
Hypsibius dujardini,135,70,230,223,0,658,
Hypsiglena chlorophaea,206,69,169,237,0,681,
Hypsiglena chlorophaea,207,69,167,238,0,681,
Hypsiglena jani,192,71,184,234,0,681,
Hypsiglena ochrorhyncha,210,71,163,237,0,681,
Hypsiglena ochrorhyncha,208,73,164,236,0,681,
Hypsiglena ochrorhyncha,204,67,163,247,0,681,
Hypsiglena slevini,200,67,175,239,0,681,
Hypsiglena sp.,201,67,176,237,0,681,
Hypsiglena torquata,212,71,163,235,0,681,
Hypsiglena unaocularus,203,68,172,238,0,681,
Hyriopsis cumingii,77,211,307,113,0,708,
Hyriopsis schlegelii,70,207,314,117,0,708,
Ibacus ciliatus,129,67,268,217,0,681,
Ibalia leucospoides,63,44,315,247,0,669,
Ibidoecus bisignatus,75,94,314,213,0,696,
Ichthyaetus relictus,252,68,165,199,0,684,
Ichthyoelephas longirostris,214,105,195,170,0,684,
Ichthyomyzon fossor,175,57,222,225,0,679,
Ichthyomyzon unicuspis,175,57,222,225,0,679,
Ichthyophis bannanicus,193,65,198,228,0,684,
Ichthyophis bombayensis,184,62,202,236,0,684,
Ichthyophis glutinosus,180,55,210,238,0,683,
Ictalurus punctatus,216,84,185,199,0,684,
Ictiobus bubalus,192,105,199,188,0,684,
Ictiobus cyprinellus,192,107,199,186,0,684,
Ideopsis similis,84,55,298,238,0,675,
Ifremeria nautilei,124,122,291,159,0,696,
Igernella notabilis,83,134,287,221,4,729,
Iguana iguana,239,77,170,196,0,682,
Ijimaia dofleini,194,84,198,207,0,683,
Ilisha africana,216,79,193,195,0,683,
Ilisha elongata,213,80,196,194,0,683,
Illex argentinus,125,67,277,224,0,693,
Ilyanassa obsoleta,113,102,300,181,0,696,
Ilyocoris cimicoides,118,84,205,263,0,670,
Ilyophis brunneus,193,84,196,210,0,683,
Ilyoplax deschampsi,146,74,261,194,0,675,
Imantodes cenchoa,184,63,186,248,0,681,
Indostomus paradoxus,275,86,165,157,0,683,
Indotestudo elongata,191,57,194,242,0,684,
Indotestudo forstenii,194,62,196,232,0,684,
Indotyphlus maharashtraensis,148,66,232,238,0,684,
Indri indri,193,86,206,196,0,681,
Inia geoffrensis,198,72,194,217,0,681,
Iotrochota birotulata,77,165,294,198,1,735,
Ircinia strobilina,71,191,295,151,0,708,
Ischikauia steenackeri,204,93,192,195,0,684,
Ischnura pumilio,113,83,248,240,0,684,
Iso hawaiiensis,231,100,205,148,0,684,
Isoodon macrourus,171,65,228,217,0,681,
Isopora palifera,101,159,289,150,0,699,
Isopora togianensis,100,160,290,149,0,699,684
Issoria lathonia,91,52,299,236,0,678,
Istiophorus albicans,235,82,191,175,0,683,
Istiophorus platypterus,235,83,191,175,0,684,
Ithaginis cruentus,259,67,171,187,0,684,
Iwatanemertes piperata,84,181,306,122,0,693,
Ixobrychus cinnamomeus,238,66,169,211,0,684,
Ixobrychus eurhythmus,233,63,174,214,0,684,
Ixobrychus sinensis,238,63,167,216,0,684,
Ixodes hexagonus,139,51,252,221,0,663,
Ixodes holocyclus,98,51,282,232,0,663,
Ixodes pavlovskyi,97,45,300,221,0,663,
Ixodes persulcatus,103,44,299,217,0,663,
Ixodes ricinus,95,43,309,219,0,666,
Ixodes uriae,131,48,260,224,0,663,
Jacana jacana,241,62,187,194,0,684,
Jacana spinosa,237,59,185,194,9,684,
Jaculus jaculus,203,84,207,187,0,681,
Japonica lutea,77,54,302,245,0,678,
Japyx solifugus,154,80,211,227,0,672,
Jellisonia amadoi,97,63,288,227,0,675,
Jenkinsia lamprotaenia,235,114,186,148,0,683,
Jenkinsia sp.,222,109,199,154,0,684,
Jinshaia abbreviata,221,94,188,181,0,684,
Jinshaia sinensis,222,92,189,181,0,684,
Johnius belangerii,134,130,276,144,0,684,
Johnius grypotus,130,127,276,150,0,683,
Jordanella floridae,233,78,209,163,0,683,
Junceella fragilis,125,117,268,198,0,708,
Junonia almana,89,56,292,241,0,678,
Junonia orithya,82,56,300,240,0,678,
Kali indica,189,87,219,188,0,683,
Kallima inachus,84,55,306,233,0,678,
Kaloula borealis,201,77,214,190,0,682,
Kaloula pulchra,189,73,224,196,0,682,
Kamimuria wangi,140,79,259,200,0,678,
Kareius bicoloratus,223,96,205,159,0,683,
Katharina tunicata,68,138,328,159,0,693,
Katsuwonus pelamis,224,88,183,189,0,684,
Kaupichthys hyoproroides,201,86,191,202,0,680,
Kentrocapros aculeatus,208,88,203,184,0,683,
Keratoisidinae sp.,118,125,277,197,0,717,
Kichulchoia multifasciata,176,99,219,190,0,684,
Kingdonella bicollina,93,62,268,255,0,678,
Kinosternon leucostomum,182,61,200,241,0,684,
Kinyongia fischeri,231,89,164,186,0,670,
Kneria sp.,205,85,192,201,0,683,
Kobus ellipsiprymnus,191,73,191,226,0,681,
Kobus leche,186,71,198,226,0,681,
Kogia breviceps,215,76,180,210,0,681,
Konosirus punctatus,208,113,194,169,0,684,
Koreocobitis naktongensis,179,100,217,188,0,684,
Koreocobitis rotundicaudata,188,104,205,187,0,684,
Kryptolebias marmoratus,208,91,212,173,0,684,
Kuhlia mugil,229,91,195,168,0,683,
Kurtus gulliveri,222,75,193,194,0,684,
Kyphosus cinerascens,241,91,184,167,0,683,
Labeo angra,203,99,181,200,0,683,
Labeo bata,187,86,194,216,0,683,
Labeo batesii,201,89,184,210,0,684,
Labeo calbasu,193,91,187,213,0,684,
Labeo chrysophekadion,195,85,189,214,0,683,
Labeo cyclorhynchus,200,90,185,208,0,683,
Labeo fimbriatus,209,88,174,213,0,684,
Labeo lineatus,201,88,186,208,0,683,
Labeo pierrei,202,91,182,208,0,683,
Labeo rohita,203,87,184,210,0,684,
Labeo senegalensis,191,84,195,214,0,684,
Labichthys carinatus,184,106,210,183,0,683,
Labiobarbus leptocheilus,189,88,191,215,0,683,
Labiobarbus lineatus,189,87,187,220,0,683,
Labiobarbus ocellatus,175,86,205,217,0,683,
Labracinus cyclophthalmus,213,90,190,190,0,683,
Labracoglossa argentiventris,204,83,219,177,0,683,
Laccotrephes robustus,110,73,215,269,0,667,
Lacerta agilis,198,68,206,208,0,680,
Lacerta viridis,199,71,201,210,0,681,
Lactoria diaphana,200,79,215,189,0,683,
Ladislavia taczanowskii,205,104,193,182,0,684,
Laeops lanceolata,230,117,183,153,0,683,
Lagenorhynchus albirostris,199,67,201,214,0,681,
Lagocephalus laevigatus,222,88,203,170,0,683,
Lagocephalus lagocephalus,236,85,186,176,0,683,
Lagocephalus lunaris,231,97,185,170,0,683,
Lagocephalus sceleratus,247,106,167,163,0,683,
Lagocephalus spadiceus,242,88,189,165,0,684,
Lagocephalus suezensis,239,99,182,164,0,684,
Lagocephalus wheeleri,245,91,182,165,0,683,
Lagorchestes hirsutus,203,68,199,211,0,681,
Lagostrophus fasciatus,200,68,199,214,0,681,
Lagothrix lagotricha,190,62,202,227,0,681,
Lama glama,184,81,206,210,0,681,
Lama guanicoe,183,92,208,198,0,681,
Lama pacos,184,82,205,210,0,681,
Lamellibrachia luymesi,170,72,270,175,0,687,
Lamna ditropis,206,88,202,188,0,684,
Lampadena atlantica,249,100,174,161,0,684,
Lampetra aepyptera,176,73,219,211,0,679,
Lampetra appendix,179,66,219,215,0,679,
Lampetra fluviatilis,178,64,218,219,0,679,
Lampris guttatus,241,90,187,166,0,684,
Lamprogrammus niger,204,117,182,180,0,683,
Lamproptera curius,83,53,311,231,0,678,
Lamprotula coreana,77,180,303,142,0,702,
Lamprotula gottschei,72,181,309,140,0,702,
Lamprotula leai,78,211,305,114,0,708,
Lamprotula tortuosa,70,180,309,143,0,702,
Lampsilis ornata,73,211,303,121,0,708,
Lanceolaria grayana,73,194,306,129,0,702,
Lanius tephronotus,208,71,185,220,0,684,
Laodelphax striatellus,127,49,248,231,0,655,
Laomedea flexuosa,87,108,294,216,0,705,
Laqueus rubellus,94,186,280,121,0,681,
Larimichthys crocea,234,94,190,166,0,684,
Larimichthys polyactis,248,89,183,164,0,684,
Larus brunnicephalus,256,68,161,199,0,684,
Larus crassirostris,248,68,167,201,0,684,
Larus dominicanus,252,69,164,199,0,684,
Lasiopodomys mandarinus,200,74,202,205,0,681,
Lasiurus borealis,150,84,235,212,0,681,
Lasmigona compressa,75,146,305,176,0,702,
Lateolabrax maculatus,230,98,186,170,0,684,
Laternaria candelaria,125,55,197,275,0,652,
Laternula elliptica,117,197,242,140,0,696,
Lates calcarifer,223,92,189,180,0,684,
Latimeria chalumnae,197,83,166,215,0,661,
Latimeria menadoensis,203,81,172,227,0,683,
Lechriodus melanopyga,205,88,216,175,0,684,
Lefua echigonia,177,95,227,185,0,684,
Leggadina lakedownensis,186,62,193,240,0,681,
Leiocassis crassilabris,186,80,200,218,0,684,
Leiocassis longirostris,191,79,193,221,0,684,
Leiocephalus personatus,170,72,222,219,0,683,
Leiolepis guttata,224,70,167,221,0,682,
Leiolepis reevesii,206,68,187,221,0,682,
Leiopelma archeyi,219,93,178,194,0,684,
Leiopelma hochstetteri,183,80,222,196,1,682,
Leiothrix argentauris,244,72,173,195,0,684,
Leiothrix lutea,240,67,175,202,0,684,
Lemur catta,195,65,213,208,0,681,
Lemyra melli,99,59,282,238,0,678,
Lentula callani,101,64,248,262,0,675,
Leontopithecus rosalia,174,65,220,222,0,681,
Leopoldamys edwardsi,196,73,192,220,0,681,
Lepas anserifera,134,120,233,179,0,666,
Lepas australis,123,85,258,200,0,666,
Lepeophtheirus salmonis,96,144,236,178,0,654,
Lepidoblepharon ophthalmolepis,237,93,195,159,0,684,
Lepidocampa weberi,175,58,226,216,0,675,
Lepidochelys olivacea,189,57,198,239,0,683,
Lepidodermella squamata,76,109,202,81,0,468,
Lepidophyma flavimaculatum,232,75,176,197,0,680,
Lepidopsocid sp.,88,60,285,242,0,675,
Lepidosiren paradoxa,182,80,243,206,0,711,
Lepilemur hubbardorum,214,77,193,197,0,681,
Lepilemur ruficaudatus,212,74,196,199,0,681,
Lepisosteus oculatus,210,82,202,190,0,684,
Lepisosteus osseus,210,83,203,187,0,683,
Lepisosteus spatula,221,85,185,192,0,683,
Lepomis cyanellus,232,92,195,165,0,684,
Lepomis macrochirus,244,90,183,167,0,684,
Leporinus piavussu,197,86,217,184,0,684,
Leptidea morsei,81,49,307,247,0,684,
Leptobarbus hoevenii,207,82,186,208,0,683,
Leptobelus gazella,96,51,257,247,0,651,
Leptobotia elongata,201,96,200,187,0,684,
Leptobotia mantschurica,181,88,214,201,0,684,
Leptobotia microphthalma,202,95,199,188,0,684,
Leptobotia rubrilabris,194,96,204,190,0,684,
Leptobotia taeniops,197,93,196,198,0,684,
Leptobrachium boringii,176,88,246,172,0,682,
Leptocephalus sp.,193,93,199,198,0,683,
Leptochilichthys agassizii,231,103,179,170,0,683,
Leptodeira septentrionalis,189,68,179,245,0,681,
Leptoderma lubricum,222,89,190,183,0,684,
Leptoderma macrophthalmum,220,94,192,178,0,684,
Leptoderma retropinna,216,90,200,178,0,684,
Leptolalax oshanensis,216,79,222,165,0,682,
Leptomantella albella,118,70,268,222,0,678,
Leptomyrmex pallens,173,58,239,191,2,663,
Leptonychotes weddellii,197,70,203,211,0,681,
Leptorhynchoides thecatus,74,99,235,152,1,561,
Leptotila verreauxi,234,75,186,188,0,683,
Leptotrombidium akamushi,117,71,242,188,0,618,
Leptotrombidium deliense,104,71,258,185,0,618,
Leptotrombidium pallidum,95,69,260,200,0,624,
Lepturichthys fimbriata,217,91,192,184,0,684,
Lepus americanus,203,74,197,207,0,681,
Lepus capensis,190,78,205,208,0,681,
Lepus coreanus,195,79,200,207,0,681,
Lepus europaeus,187,76,205,213,0,681,
Lepus granatensis,194,80,201,206,0,681,
Lepus hainanus,196,80,197,208,0,681,
Lepus sinensis,201,78,198,204,0,681,
Lepus timidus,195,79,200,207,0,681,
Lepus tolai,190,78,205,208,0,681,
Lepus townsendii,189,71,205,216,0,681,
Lernaea cyprinacea,80,137,284,180,0,681,
Lethe dura,97,54,303,224,0,678,
Lethenteron camtschaticum,189,76,230,219,0,714,
Lethenteron reissneri,185,76,235,218,0,714,
Lethocerus indicus,127,76,186,275,0,664,
Lethrinus obsoletus,242,96,185,160,0,683,
Leucaspius delineatus,198,102,199,185,0,684,
Leuciscus baicalensis,192,109,197,186,0,684,
Leuciscus waleckii,189,112,200,183,0,684,
Leucoptera malifoliella,84,46,306,242,0,678,
Leucoraja erinacea,194,78,215,197,0,684,
Leucosticte arctoa,244,77,162,201,0,684,
Leucosticte brandti,242,72,167,203,0,684,
Lewinia muelleri,244,60,170,210,0,684,
Lexias dirtea,83,53,313,229,0,678,
Liachirus melanospilos,215,70,191,208,0,684,
Libelloides macaronius,118,73,241,245,0,677,
Libythea celtis,79,54,318,227,0,678,
Ligia oceanica,138,149,221,164,0,672,
Limnonectes bannaensis,192,69,231,190,0,682,
Limnonectes fujianensis,207,77,218,180,0,682,
Limnoria quadripunctata,145,83,252,183,0,663,
Limulus polyphemus,177,55,228,215,0,675,
Lineus alborostratus,82,175,306,130,0,693,
Lineus viridis,77,160,331,125,0,693,
Liobagrus anguillicauda,196,95,181,212,0,684,
Liobagrus kingi,210,90,167,217,0,684,
Liobagrus marginatoides,196,96,181,210,0,683,
Liobagrus marginatus,210,90,167,217,0,684,
Liobagrus mediadiposalis,196,92,181,215,0,684,
Liobagrus nigricauda,195,96,182,211,0,684,
Liobagrus obesus,202,98,172,211,0,683,
Liphistius erawan,164,44,256,199,0,663,
Lipolagus ochotensis,236,97,202,148,0,683,
Liposcelis decolor,77,75,302,194,0,648,
Liposcelis entomophila,5,7,22,15,0,49,
Liposcelis entomophila,61,65,318,198,0,642,
Liposcelis paeta,83,79,304,191,0,657,
Liposcelis paeta,71,70,259,162,0,562,
Lipotes vexillifer,213,61,182,225,0,681,
Liriomyza bryoniae,103,64,277,234,0,678,
Liriomyza huidobrensis,108,66,273,231,0,678,
Liriomyza sativae,109,73,280,216,0,678,
Liriomyza trifolii,108,73,274,217,6,678,
Lissemys punctata,189,58,185,252,0,684,
Lissemys scutata,198,58,179,249,0,684,
Lista haraldusalis,84,60,319,218,0,681,
Lithobius forficatus,137,81,238,213,0,669,
Lithodes nintokuae,115,77,274,209,0,675,
Litocranius walleri,181,66,206,228,0,681,
Litopenaeus stylirostris,134,94,254,193,0,675,
Litopenaeus vannamei,140,91,250,194,0,675,
Liua shihi,136,73,246,229,0,684,
Liua tsinpaensis,143,79,241,221,0,684,
Liza affinis,217,83,208,176,0,684,
Liza haematocheila,225,87,200,172,0,684,
Loa loa,40,97,336,109,0,582,
Lobodon carcinophaga,195,74,202,210,0,681,
Locusta migratoria,99,63,252,264,0,678,
Locusta migratoria,108,67,243,260,0,678,
Locusta migratoria,107,65,245,261,0,678,
Locusta migratoria,99,66,251,262,0,678,
Loligo bleekeri,139,70,288,208,0,705,
Loliolus uyii,139,63,269,222,0,693,
Lophelia pertusa,96,159,292,152,0,699,
Lophiodes caulinaris,186,94,225,178,0,683,
Lophiomus setigerus,217,108,193,166,0,684,
Lophiosilurus alexandri,194,78,192,220,0,684,
Lophiotoma cerithiformis,113,94,302,187,0,696,
Lophius americanus,233,96,190,164,0,683,
Lophius litulon,225,87,202,169,0,683,
Lophocebus aterrimus,223,65,171,222,0,681,
Lophophorus lhuysii,247,67,174,196,0,684,
Lophophorus sclateri,250,70,172,192,0,684,
Lophostoma silvicolum,216,76,179,210,0,681,
Lophura ignita,245,71,178,190,0,684,
Lophura nycthemera,245,73,180,186,0,684,
Lophura swinhoii,249,74,176,185,0,684,
Loripes lacteus,65,180,278,122,0,645,
Loris lydekkerianus,193,75,200,213,0,681,
Loris tardigradus,195,70,197,219,0,681,
Lota lota,211,88,209,175,0,683,
Lottia digitalis,127,212,316,197,0,852,
Loxechinus albus,161,99,231,199,0,690,
Loxia curvirostra,241,66,166,211,0,684,
Loxioides bailleui,237,81,170,196,0,684,
Loxocorone allax,80,90,319,213,0,702,
Loxodonta africana,187,73,199,210,0,669,
Loxodonta cyclotis,186,77,198,208,0,669,
Loxops caeruleirostris,231,70,174,208,1,684,
Loxops coccineus,234,72,171,207,0,684,
Loxops mana,236,72,168,208,0,684,
Loxosomella aloxiata,109,108,294,194,0,705,
Loxostege sticticalis,87,60,292,236,0,675,
Lubomirskia baicalensis,107,122,303,203,0,735,
Lucanus mazama,156,80,242,197,0,675,
Lucilia cuprina,104,74,291,209,0,678,
Lucilia porphyrina,111,73,280,214,0,678,
Lucilia sericata,102,72,293,211,0,678,
Lucinella divaricata,79,180,292,139,0,690,
Luciobarbus capito,201,98,180,205,0,684,
Luciogobius pallidus,199,89,220,176,0,684,
Luciogobius platycephalus,190,86,227,181,0,684,
Luciola cruciata,120,65,245,245,0,675,
Luciosoma bleekeri,194,93,199,197,0,683,
Luehdorfia taibai,81,49,308,243,0,681,
Luetkenotyphlus brasiliensis,210,72,192,210,0,684,
Luidia quinaria,183,89,240,181,0,693,
Lumbricus terrestris,191,86,222,195,0,694,
Luscinia calliope,258,72,156,198,0,684,
Luscinia cyanura,260,77,158,189,0,684,
Lutjanus argentimaculatus,235,86,183,180,0,684,
Lutjanus bengalensis,229,84,192,179,0,684,
Lutjanus johnii,232,91,194,167,0,684,
Lutjanus kasmira,232,92,189,171,0,684,
Lutjanus malabaricus,235,89,196,164,0,684,
Lutjanus rivulatus,241,97,179,166,0,683,
Lutjanus russellii,237,88,184,175,0,684,
Lutjanus sebae,222,83,199,180,0,684,
Lutra lutra,201,83,194,203,0,681,
Lutraria rhynchaena,107,179,317,156,0,759,
Luvarus imperialis,225,94,199,165,0,683,
Lycaena phlaeas,82,51,305,240,0,678,
Lycengraulis grossidens,199,91,210,184,0,684,
Lyciasalamandra atifi,186,80,214,204,0,684,
Lycodes toyamensis,228,104,191,160,0,683,
Lycodon rufozonatus,205,66,161,249,0,681,
Lycorma delicatula,106,53,203,290,0,652,
Lycothrissa crocodilus,204,82,190,208,0,684,
Lygus hesperus,94,79,232,279,0,684,
Lygus lineolaris,90,80,236,278,0,684,
Lymantria dispar,107,57,283,231,0,678,
Lynx lynx,199,85,194,203,0,681,
Lynx rufus,193,83,199,206,0,681,
Lyreidus brevifrons,129,81,278,187,0,675,
Lyrurus tetrix,233,73,190,188,0,684,
Lysiosquillina maculata,169,91,226,189,0,675,
Macaca arctoides,231,72,161,217,0,681,
Macaca assamensis,230,72,166,213,0,681,
Macaca fascicularis,234,68,159,220,0,681,
Macaca fuscata,224,70,169,218,0,681,
Macaca mulatta,222,71,170,218,0,681,
Macaca nemestrina,230,62,163,226,0,681,
Macaca nigra,229,64,165,223,0,681,
Macaca silenus,224,61,170,226,0,681,
Macaca sylvanus,224,60,171,226,0,681,
Macaca thibetana,233,71,161,216,0,681,
Macaca tonkeana,224,72,169,216,0,681,
Maccullochella peeli / Maccullochella peelii,206,73,203,202,0,684,
Macquaria ambigua,210,87,209,177,0,683,
Macquaria australasica,217,80,203,184,0,684,
Macracanthorhynchus hirudinaceus,52,154,248,137,0,591,
Macroagelaius imthurni,253,70,156,205,0,684,
Macrobrachium lanchesteri,154,88,224,209,0,675,
Macrobrachium nipponense,163,92,210,210,0,675,
Macrobrachium rosenbergii,197,102,178,196,0,673,
Macrochelys temminckii,189,67,195,245,0,696,
Macrochirichthys macrochirus,189,79,207,208,0,683,
Macrognathotermes errator,153,76,178,271,0,678,
Macrogyrus oblongus,114,67,280,217,0,678,
Macropicola ocydromi,36,109,291,164,0,600,
Macropodus ocellatus,176,83,234,191,0,684,
Macropodus opercularis,186,81,223,194,0,684,
Macropus robustus,203,67,200,211,0,681,
Macroramphosus scolopax,241,86,189,167,0,683,
Macrorhamphosodes uradoi,224,92,197,170,0,683,
Macroscelides proboscideus,175,68,205,233,0,681,
Macrotermes barneyi,157,75,167,282,0,681,
Macrotermes natalensis,170,73,155,283,0,681,
Macrotermes subhyalinus,172,74,154,281,0,681,
Macrotis lagotis,157,68,224,230,0,679,
Mactra chinensis,90,168,315,166,0,739,
Madoqua kirkii,192,84,202,203,0,681,
Madoqua saltiana,189,79,205,208,0,681,
Madracis mirabilis,81,120,308,169,0,678,
Madrepora oculata,72,114,336,159,0,681,
Makaira indica,236,83,189,176,0,684,
Makaira mazara,237,87,186,174,0,684,
Malacochersus tornieri,199,57,186,242,0,684,
Malapterurus electricus,196,71,197,219,0,683,
Malcus inconspicuus,93,53,241,276,0,663,
Mallotus villosus,221,97,207,159,0,684,
Malurus melanocephalus,235,74,168,207,0,684,
Mammut americanum,182,78,200,209,0,669,
Mammuthus columbi,178,80,205,206,0,669,
Mammuthus primigenius,178,81,205,205,0,669,
Mandrillus sphinx,226,67,167,221,0,681,
Manduca sexta,75,54,305,244,0,678,
Manis javanica,224,81,161,215,0,681,
Manis pentadactyla,223,80,161,217,0,681,
Manis temminckii,188,73,200,220,0,681,
Manis tetradactyla,175,72,212,222,0,681,
Manis tricuspis,182,76,206,217,0,681,
Manouria emys,203,74,183,221,0,681,
Manouria impressa,193,65,193,233,0,684,
Mantella madagascariensis,164,76,261,181,0,682,
Marcusenius senegalensis,209,87,188,200,0,684,
Margaritifera falcata,81,191,307,129,0,708,
Marilyna darwinii,240,89,178,176,0,683,
Marisa cornuarietis,109,102,313,169,0,693,
Marmota himalayana,177,73,225,205,0,680,
Marphysa sanguinea,203,82,219,198,0,702,
Marsupenaeus japonicus,153,92,243,187,0,675,
Martes americana,213,83,183,202,0,681,
Martes flavigula,195,80,197,209,0,681,
Martes foina,203,84,189,205,0,681,
Martes martes,210,81,185,205,0,681,
Martes melampus,213,88,183,197,0,681,
Martes pennanti,202,75,194,210,0,681,
Martes zibellina,210,87,185,199,0,681,
Maruca testulalis,85,64,292,234,0,675,
Maruca vitrata,90,64,291,230,0,675,
Massicus raddei,133,74,247,221,0,675,
Mastacembelus armatus,232,87,194,170,0,683,
Mastacembelus favus,221,74,201,187,0,683,
Mastigeulota kiangsinensis,117,100,253,187,0,657,
Mastigoproctus giganteus,137,66,260,209,0,672,
Mastotermes darwiniensis,136,83,228,234,0,681,
Masturus lanceolatus,227,90,196,170,0,683,
Maulisia mauli,255,107,165,156,0,683,
Mauremys annamensis,189,66,194,235,0,684,
Mauremys japonica,201,66,180,237,0,684,
Mauremys mutica,192,71,192,229,0,684,
Mauremys sinensis,192,68,187,237,0,684,
Mayetiola destructor,70,47,282,273,0,672,
Mazama americana,181,81,207,212,0,681,
Mazama gouazoupira,179,73,205,224,0,681,
Mazama nemorivaga,168,74,216,223,0,681,
Mazama rufina,166,75,218,222,0,681,
Mecistocirrus digitatus,36,93,283,188,0,600,
Mecistops cataphractus,210,68,180,238,0,696,
Mecopoda elongata,129,77,267,205,0,678,
Mecopoda niponensis,130,76,276,196,0,678,
Megabalanus ajax,135,71,250,210,0,666,
Megabalanus volcano,124,74,267,201,0,666,
Megachasma pelagios,172,68,230,214,0,684,
Megacopta cribraria,130,88,205,247,0,670,
Megacrania alpheus,95,56,229,292,0,672,
Megaladapis edwardsi,199,77,199,206,0,681,
Megalaspis cordyla,215,84,198,181,0,678,
Megalobrama amblycephala,201,92,194,197,0,684,
Megalobrama amblycephala,206,95,187,196,0,684,
Megalobrama amblycephala,201,92,194,197,0,684,
Megalobrama amblycephala,202,93,193,196,0,684,
Megalobrama pellegrini,202,93,193,196,0,684,
Megalobrama skolkovii,202,92,193,197,0,684,
Megalobrama terminalis,199,93,196,196,0,684,
Megalops atlanticus,215,94,175,199,0,683,
Megalops cyprinoides,217,92,175,199,0,683,
Megaptera novaeangliae,206,67,189,219,0,681,
Megaselia scalaris,105,78,281,214,0,678,
Mekongiana xiangchengensis,117,64,239,258,0,678,
Mekongiella kingdoni,122,60,228,268,0,678,
Mekongiella xizangensis,108,63,239,268,0,678,
Melamprosops phaeosoma,241,64,166,213,0,684,
Melanargia asiatica,98,52,301,227,0,678,
Melanitis leda,87,52,312,227,0,678,
Melanitis phedima,86,53,312,227,0,678,
Melanocetus johnsoni,228,100,178,178,0,684,
Melanocetus murrayi,224,101,181,177,0,683,
Melanogrammus aeglefinus,175,82,242,185,0,684,
Melanotaenia lacustris,238,87,192,166,0,683,
Melanotaenia parkinsoni,229,83,196,176,0,684,
Meleagris gallopavo,230,70,193,191,0,684,
Meles anakuma,185,73,209,214,0,681,
Meles meles,182,75,208,216,0,681,
Melibe leonina,133,115,238,180,0,666,
Melichthys vidua,238,89,189,167,0,683,
Melipona bicolor,63,29,341,251,0,684,
Melipona scutellaris,68,28,335,253,0,684,
Melitaea cinxia,95,53,283,247,0,678,
Melogale moschata,197,87,197,200,0,681,
Meloidogyne arenaria,14,53,301,184,0,552,
Meloidogyne chitwoodi,8,67,327,147,0,549,
Meloidogyne enterolobii,14,60,293,185,0,552,
Meloidogyne graminicola,13,59,301,149,0,522,
Meloidogyne incognita,14,52,301,185,0,552,
Meloidogyne javanica,13,54,303,182,0,552,
Melopsittacus undulatus,247,59,168,210,0,684,
Melursus ursinus,190,103,206,182,0,681,
Membranipora grandicella,117,70,263,204,0,654,
Mengenilla moldrzyki,92,34,310,224,0,660,
Menidia menidia,233,95,192,164,0,684,
Menura novaehollandiae,229,71,175,209,0,684,
Mephitis mephitis,191,77,203,210,0,681,
Meretrix lamarckii,98,198,361,192,0,849,
Meretrix lusoria,82,187,381,199,0,849,
Meretrix lyrata,83,180,389,197,0,849,
Meretrix meretrix,82,181,380,206,0,849,
Meretrix petechialis,82,183,380,204,0,849,
Mergus squamatus,257,85,157,185,0,684,
Meriones unguiculatus,172,73,215,221,0,681,
Merlangius merlangus,174,81,239,189,1,684,
Merluccius merluccius,244,86,185,169,0,684,
Mesobuthus gibbosus,66,153,295,149,0,663,
Mesobuthus martensii,65,170,291,137,0,663,
Mesocentrotus franciscanus,159,105,233,193,0,690,
Mesocentrotus nudus,169,108,223,190,0,690,
Mesocottus haitej,237,95,187,165,0,684,
Mesocricetus auratus,173,70,218,220,0,681,
Mesoplodon densirostris,182,61,212,226,0,681,
Mesoplodon europaeus,197,65,199,220,0,681,
Mesoplodon grayi,177,58,218,228,0,681,
Metachirus nudicaudatus,164,62,231,224,0,681,
Metacrangonyx dominicanus,92,90,290,197,0,669,
Metacrangonyx goulmimensis,114,103,267,185,0,669,
Metacrangonyx ilvanus,102,87,295,185,0,669,
Metacrangonyx longicaudus,75,78,295,221,0,669,
Metacrangonyx longipes,79,82,303,205,0,669,
Metacrangonyx panousei,83,84,294,208,0,669,
Metacrangonyx remyi,93,104,288,184,0,669,
Metacrangonyx repens,73,77,309,210,0,669,
Metacrangonyx spinicaudatus,80,70,299,220,0,669,
Metagonimus yokogawai,74,151,217,74,0,516,
Metahomaloptera omeiensis,201,103,206,174,0,684,
Metanephrops sibogae,152,89,248,186,0,675,
Metapenaeus ensis,164,87,229,195,0,675,
Metaperipatus inae,61,86,307,224,0,678,
Metaphire vulgaris,154,79,231,230,0,694,
Metaseiulus occidentalis,119,52,279,219,0,669,
Metastrongylus pudendotectus,29,96,337,141,0,603,
Metastrongylus salmi,31,117,322,127,0,597,
Metridium senile,118,132,274,166,0,690,
Metzia formosae,194,92,195,203,0,684,
Metzia longinasus,186,85,202,211,0,684,
Metzia mesembrinum,183,88,209,204,0,684,
Meuschenia hippocrepis,231,105,197,150,0,683,
Micadina phluctainoides,94,66,235,280,0,675,
Micrastur gilvicollis,252,65,169,198,0,684,
Microcaecilia dermatophaga,190,78,189,227,0,684,
Microcaecilia sp.,161,65,221,237,0,684,
Microcaecilia unicolor,167,70,214,233,0,684,
Microcerotermes parvus,156,89,175,258,0,678,
Microcosmus sulcatus,49,155,290,148,0,642,
Microcotyle sebastis,74,92,246,158,0,570,
Microdevario kubotai,183,90,213,197,0,683,
Microdevario nana,199,95,196,193,0,683,
Microhodotermes viator,155,79,175,272,0,681,
Microhyla heymonsi,177,74,251,180,0,682,
Microhyla okinavensis,191,83,234,174,0,682,
Microhyla ornata,179,79,249,175,0,682,
Microhyla pulchra,204,75,225,178,0,682,
Micromelo undata,119,105,263,173,0,660,
Micromesistius poutassou,216,96,193,177,0,682,
Micronycteris megalotis,220,74,177,210,0,681,
Micropercops swinhonis,183,87,233,181,0,684,
Microphis brachyurus,191,93,218,181,0,683,
Microphysogobio alticorpus,200,94,204,186,0,684,
Microphysogobio brevirostris,183,101,211,189,0,684,
Microphysogobio fukiensis,200,90,205,189,0,684,
Microphysogobio koreensis,196,95,203,190,0,684,
Microphysogobio longidorsalis,199,103,204,177,0,683,
Microphysogobio tafangensis,206,95,193,189,0,683,
Microphysogobio yaluensis,192,101,211,180,0,684,
Micropterus dolomieu,223,99,203,158,0,683,
Micropterus floridanus,224,90,203,167,0,684,
Micropterus salmoides,221,93,207,163,0,684,
Micropterus salmoides,220,91,208,165,0,684,
Microthrissa congica,213,94,196,181,0,684,
Microthrissa royauxi,214,90,193,187,0,684,
Microtus fortis,217,69,188,207,0,681,
Microtus fortis,218,70,187,206,0,681,
Microtus kikuchii,210,73,188,210,0,681,
Microtus levis,199,72,204,206,0,681,
Micrura ignea,106,202,281,104,0,693,
Micrurus fulvius,203,59,185,230,2,679,
Mictyris longicarpus,130,77,286,182,0,675,
Miichthys miiuy,264,87,176,157,0,684,
Mimachlamys nobilis,76,194,271,152,0,693,
Mimachlamys senatoria,112,244,337,189,0,882,
Minytrema melanops,162,90,223,209,0,684,
Mionectes oleagineus,237,62,193,192,0,684,
Mirounga leonina,185,70,214,212,0,681,
Misgurnus anguillicaudatus,192,94,212,186,0,684,
Misgurnus bipartitus,177,96,213,198,0,684,
Misgurnus mohoity,192,94,211,187,0,684,
Misgurnus nikolskyi,192,100,210,182,0,684,
Mitsukurina owstoni,181,66,218,219,0,684,
Mizuhopecten yessoensis,118,214,276,127,0,735,
Mobula eregoodootenkee,199,76,215,194,0,684,
Mobula japanica,188,70,226,198,2,684,
Moerella iridescens,76,185,356,160,0,777,
Mogera wogura,174,73,211,223,0,681,
Mogurnda adspersa,190,92,203,199,0,684,
Mola mola,233,93,195,162,0,683,
Molothrus aeneus,251,68,162,203,0,684,
Molothrus badius,250,77,158,199,0,684,
Monacanthus chinensis,220,89,209,165,0,683,
Monachus schauinslandi,198,71,204,208,0,681,
Mongoloraphidia harmandi,91,57,296,231,0,675,
Monocentris japonicus,226,85,192,180,0,683,
Monochamus alternatus,88,62,290,235,0,675,
Monodactylus argenteus,230,91,202,160,0,683,
Monodelphis domestica,176,66,210,229,0,681,
Monodon monoceros,205,63,190,223,0,681,
Monognathus jesperseni,196,82,218,184,0,680,
Monopterus albus,221,80,203,179,0,683,
Monotaxis grandoculis,255,102,168,158,0,683,
Monotrete cochinchinensis,237,80,187,179,0,683,
Monotrete leiurus,237,79,185,183,0,684,
Montastraea annularis,94,122,320,142,0,678,
Montastraea faveolata,94,122,320,142,0,678,
Montastraea franksi,94,122,320,142,0,678,
Montifringilla adamsi,248,77,155,204,0,684,
Montifringilla nivalis,244,84,159,197,0,684,
Montifringilla ruficollis,230,68,174,212,0,684,
Montifringilla taczanowskii,233,69,171,211,0,684,
Montipora cactus,103,165,283,148,0,699,
Moolgarda cunnesius,260,121,259,214,0,854,
Mordella atrata,128,66,270,205,0,669,
Moringua edwardsi,210,85,194,194,0,683,
Moringua microchir,222,81,177,203,0,683,
Morone saxatilis,224,99,214,147,0,684,
Moschus anhuiensis,192,76,194,219,0,681,
Moschus berezovskii,190,75,196,220,0,681,
Moschus chrysogaster,191,76,195,219,0,681,
Moschus moschiferus,188,71,195,227,0,681,
Moxostoma congestum,177,101,213,193,0,684,
Moxostoma poecilurum,177,95,214,198,0,684,
Mugil cephalus,227,78,195,183,0,683,
Mugil curema,226,84,194,180,0,684,
Mugilogobius abei,211,104,211,158,0,684,
Mugilogobius chulae,198,99,221,166,0,684,
Mulloidichthys vanicolensis,219,109,184,171,0,683,
Muntiacus crinifrons,183,81,204,213,0,681,
Muntiacus muntjak,183,80,206,212,0,681,
Muntiacus reevesi,185,82,204,210,0,681,
Muntiacus reevesi,185,82,204,210,0,681,
Muntiacus vuquangensis,179,78,209,215,0,681,
Muraenesox bagio,165,92,224,202,0,683,
Murina leucogaster,176,92,204,209,0,681,
Murina ussuriensis,170,82,210,219,0,681,
Mus caroli,172,71,213,225,0,681,
Mus cervicolor,177,69,204,231,0,681,
Mus cookii,178,69,207,227,0,681,
Mus fragilicauda,183,71,202,225,0,681,
Mus musculus,179,66,204,232,0,681,
Mus musculus,179,66,204,232,0,681,
Mus musculus,182,66,199,234,0,681,
Mus musculus,182,67,202,230,0,681,
Mus musculus,184,66,199,232,0,681,
Mus spretus,180,70,203,228,0,681,
Mus terricolor,184,69,206,222,0,681,
Musca domestica,101,70,286,221,0,678,
Muscina stabulans,100,68,294,216,0,678,
Musculista senhousia,91,142,313,168,0,714,
Mussa angulosa,89,124,323,142,0,678,
Mustela altaica,193,75,199,214,0,681,
Mustela erminea,191,75,199,216,0,681,
Mustela frenata,191,76,201,213,0,681,
Mustela kathiah,184,69,204,224,0,681,
Mustela nigripes,202,77,191,211,0,681,
Mustela nivalis,195,82,202,202,0,681,
Mustela putorius,199,76,194,212,0,681,
Mustela sibirica,199,79,195,208,0,681,
Mustelus griseus,173,71,232,208,0,684,
Mustelus manazo,171,73,237,203,0,684,
Mya arenaria,70,173,311,175,0,729,
Mycalesis mineus,87,53,307,231,0,678,
Myctophum affine,233,95,186,170,0,684,
Mylocheilus caurinus,187,100,203,194,0,684,
Mylopharyngodon piceus,202,91,189,202,0,684,
Myodes regulus,195,72,202,212,0,681,
Myomenippe fornasinii,139,72,278,186,0,675,
Myomyrus macrops,225,95,181,183,0,684,
Myosotella myosotis,153,142,212,134,0,641,
Myospalax aspalax,190,68,203,220,0,681,
Myospalax psilurus,197,67,201,216,0,681,
Myotis brandtii,168,90,217,206,0,681,
Myotis davidii,162,81,219,219,0,681,
Myotis formosus,166,80,212,223,0,681,
Myotis ikonnikovi,160,82,218,221,0,681,
Myotis macrodactylus,161,79,217,224,0,681,
Myrichthys maculosus,219,86,188,190,0,683,
Myripristis berndti,235,92,179,177,0,683,
Myrmecobius fasciatus,197,72,200,212,0,681,
Myrmecophilus manni,137,64,240,231,0,672,
Myrmeleon immanis,116,74,269,219,0,678,
Myrmica scabrinodis,93,44,315,214,0,666,
Myroconger compressus,187,103,207,189,0,686,
Mystacina tuberculata,197,81,206,197,0,681,
Mystacoleucus marginatus,189,93,188,211,0,681,
Mystus rhegma,193,91,188,212,0,684,
Mythimna separata,88,56,304,230,0,678,
Mytilus californianus,86,173,287,171,0,717,
Mytilus coruscus,87,174,278,178,0,717,
Mytilus edulis,101,175,277,164,0,717,
Mytilus galloprovincialis,101,174,278,164,0,717,
Mytilus trossulus,109,175,267,166,0,717,
Myxine glutinosa,181,68,237,201,0,687,
Myxocyprinus asiaticus,201,107,186,190,0,684,
Myxus capensis,213,98,199,174,0,684,
Nabis apicalis,101,63,273,247,0,684,
Nacospatangus alta,148,116,233,199,0,696,
Naemorhedus baileyi,185,74,198,224,0,681,
Naemorhedus caudatus,178,74,203,226,0,681,
Naemorhedus goral,180,74,199,228,0,681,
Naemorhedus griseus,183,81,199,218,0,681,
Naja atra,200,70,183,228,0,681,
Naja naja,201,71,182,226,0,680,
Nandinia binotata,207,69,188,217,0,681,
Nanger dama,191,76,193,221,0,681,
Nanger granti,189,76,195,221,0,681,
Nanger soemmerringii,190,76,195,220,0,681,
Nannoperca australis,210,87,209,178,0,684,
Nannoperca obscura,212,88,207,177,0,684,
Nannoperca variegata,213,87,206,177,0,683,
Nannospalax ehrenbergi,207,73,172,229,0,681,
Nannospalax galili,196,69,183,233,0,681,
Nannospalax golani,191,68,188,234,0,681,
Nannospalax judaei,207,73,172,229,0,681,
Nanorana parkeri,215,86,214,167,0,682,
Nanorana pleskei,220,89,212,161,0,682,
Nanorana taihangnica,219,77,207,179,0,682,
Nansenia ardesiaca,233,94,205,151,0,683,
Napialus hunanensis,86,60,293,239,0,678,
Narcetes erimelas,222,100,194,167,0,683,
Narcetes stomias,224,94,191,174,0,683,
Narceus annularus,193,61,220,202,0,676,
Narcine entemedor,144,62,233,245,0,684,
Narella hawaiinensis,113,124,279,192,0,708,
Nasalis larvatus,185,71,207,218,0,681,
Naso lopezi,234,87,189,173,0,683,
Nassarius reticulatus,114,108,294,180,0,696,
Nasua nasua,198,85,187,211,0,681,
Nasutitermes corniger,162,76,174,266,0,678,
Nasutitermes triodiae,166,77,179,256,0,678,
Natator depressa,213,54,179,237,0,683,
Natural gynogenetic,173,86,204,221,0,684,
Naupactus xanthographus,99,60,272,241,0,672,
Nautilocaris saintlaurentae,167,87,227,194,0,675,
Nautilus macromphalus,233,87,225,151,0,696,
Neaxius glyptocercus,119,108,274,173,0,674,
Necator americanus,36,108,303,151,0,598,
Necrophila americana,116,74,254,225,0,669,
Nectogale elegans,160,70,230,221,0,681,
Nectonemertes cf.,79,140,363,108,0,690,
Necturus beyeri,141,67,253,223,0,684,
Negombata magnifica,88,147,303,197,0,735,
Nelusetta ayraudi,224,101,203,155,0,683,
Nematalosa come,217,119,176,171,0,683,
Nematalosa japonica,206,119,183,175,0,683,
Nematalosa nasus,209,117,179,178,0,683,
Nematodirus oiratianus,41,102,297,158,0,598,
Nematodirus spathiger,42,108,306,144,0,600,
Nematostella sp.,127,141,263,168,0,699,
Nemertopsis tetraclitophila,63,122,396,106,0,687,
Nemichthys scolopaceus,209,104,188,182,0,683,
Nemipterus japonicus,205,94,199,186,0,684,
Nemopoda mamaevi,118,76,275,209,0,678,
Neoachiropsetta milfordi,248,104,188,143,0,683,
Neocapritermes taracua,159,74,181,264,0,678,
Neocaridina denticulata,141,104,246,184,0,675,
Neoceratias spinifer,209,108,204,162,0,683,
Neoceratodus forsteri,204,97,169,214,0,684,
Neochauliodes bowringi,118,66,266,228,0,678,
Neochauliodes fraternus,106,67,292,210,0,675,
Neochauliodes punctatolosus,113,72,265,228,0,678,
Neochauliodes rotundatus,109,65,289,212,0,675,
Neocyttus rhomboidalis,207,82,218,176,0,683,
Neodon irene,210,77,190,204,0,681,
Neofelis nebulosa,200,94,194,193,0,681,
Neogymnocrinus richeri,73,152,346,116,0,687,
Neolamprologus brichardi,225,92,203,163,0,683,
Neolissochilus hexagonolepis,190,95,195,204,0,684,
Neomaskellia andropogonis,43,67,377,146,0,633,
Neomys fodiens,185,73,212,211,0,681,
Neopanorpa pulchra,96,68,308,206,0,678,
Neope pulaha,98,55,297,228,0,678,
Neopetrolisthes maculatus,124,81,266,204,0,675,
Neophema chrysogaster,262,70,153,199,0,684,
Neophoca cinerea,202,91,192,196,0,681,
Neophocaena asiaeorientalis,203,77,193,208,0,681,
Neophocaena phocaenoides,203,77,193,208,0,681,
Neosalanx taihuensis,239,100,183,162,0,684,
Neosalanx tangkahkeii,239,100,183,162,0,684,
Neoscona theisi,70,98,302,193,0,663,
Neoscopelus macrolepidotus,222,94,195,173,0,684,
Neoscopelus microchir,225,93,195,170,0,683,
Neosynchiropus moyeri,186,98,219,181,0,684,
Neotermes insularis,146,71,204,254,0,675,
Neotetracus sinensis,170,69,231,211,0,681,
Neotragus batesi,183,67,200,231,0,681,
Neotragus moschatus,198,79,187,217,0,681,
Neotrygon kuhlii,207,72,204,201,0,684,
Neovison vison,194,74,198,215,0,681,
Nephila clavata,66,114,303,180,0,663,
Nephotettix cincticeps,75,64,266,249,0,654,
Nephrops norvegicus,113,90,285,187,0,675,
Nephtys sp.,191,88,262,156,0,697,
Neptis clinia,92,54,306,226,0,678,
Neptis philyra,88,57,307,226,0,678,
Neptis soma,90,57,303,228,0,678,
Nerodia sipedon,211,74,173,223,0,681,
Nerthra indica,115,67,227,261,0,670,
Nesiarchus nasutus,214,100,197,172,0,683,
Nesidiocoris tenuis,100,89,261,231,0,681,
Nesomachilis australica,126,76,257,216,0,675,
Nesopsar nigerrimus,247,68,167,202,0,684,
Nessorhamphus ingolfianus,204,85,198,196,0,683,
Netta rufina,251,71,162,200,0,684,
Nettastoma parviceps,178,86,214,205,0,683,
Neuroctenus parus,132,78,216,243,0,669,
Nezara viridula,90,67,259,259,0,675,
Nibea albiflora,228,89,201,166,0,684,
Nibea coibor,230,84,186,157,0,657,
Nicholsicypris normalis,174,92,219,198,0,683,
Nihonotrypaea japonica,89,122,313,151,0,675,
Nihonotrypaea thermophila,97,117,306,155,0,675,
Nilaparvata lugens,112,49,256,235,0,652,
Nilaparvata muiri,115,49,250,238,0,652,
Nimbochromis linni,238,88,193,164,0,683,
Ninguta schrenckii,95,52,310,221,0,678,
Ninox novaeseelandiae,242,65,162,215,0,684,
Nipponia nippon,251,74,157,202,0,684,
Nipponnemertes punctatula,67,165,349,111,0,692,
Nipponocypris koreanus,192,95,208,189,0,684,
Nisaetus alboniger,259,71,162,192,0,684,
Nisaetus nipalensis,256,71,164,193,0,684,
Niviventer confucianus,185,71,202,223,0,681,
Niviventer excelsior,183,69,205,224,0,681,
Niwaella delicata,182,98,218,186,0,684,
Nobia grandis,97,64,280,222,0,663,
Nomascus gabriellae,239,78,158,204,2,681,
Nomascus leucogenys,238,77,161,205,0,681,
Nomascus siki,238,78,161,204,0,681,
Nomophila noctuella,84,58,301,232,0,675,
Normichthys operosus,254,100,162,168,0,684,
Notacanthus chemnitzi,163,87,228,205,0,683,
Notemigonus crysoleucas,192,98,198,196,0,684,
Nothobranchius furzeri,185,75,222,201,0,683,
Nothopuga sp.,150,58,247,226,0,681,
Notochelys platynota,185,66,203,230,0,684,
Notochthamalus scabrosus,112,87,276,191,0,666,
Notodoris gardineri,120,100,262,184,0,666,
Notopterus notopterus,179,80,217,207,0,683,
Notoryctes typhlops,195,66,197,223,0,681,
Notorynchus cepedianus,183,70,230,201,0,684,
Notothenia coriiceps,221,111,206,158,0,696,
Notropis stramineus,193,108,211,172,0,684,
Novumbra hubbsi,184,85,238,175,0,682,
Nucifraga columbiana,237,69,169,209,0,684,
Numida meleagris,264,74,157,189,0,684,
Nuttallia olivacea,60,169,285,173,0,687,
Nuttalliella namaqua,85,47,256,272,0,660,
Nuttallina californica,152,89,316,253,0,810,
Nyctereutes procyonoides,207,81,200,193,0,681,
Nycticebus bengalensis,200,79,193,209,0,681,
Nycticebus coucang,200,79,193,209,0,681,
Nycticorax nycticorax,244,66,167,207,0,684,
Nymphes myrmeleonoides,79,63,291,245,0,678,
Nymphicus hollandicus,244,61,171,207,0,683,
Nymphon gracile,89,45,246,235,0,615,
Nyssomyia umbratilis,91,67,280,237,0,675,
Oasisia alvinae,171,81,266,172,0,690,
Obama sp.,40,74,359,202,0,675,
Occasjapyx japonicus,185,96,182,215,0,678,
Occidozyga martensii,189,71,240,182,0,682,
Ochetobius elongatus,213,96,186,189,0,684,
Ochlodes venata,89,51,318,220,0,678,
Ochotona collaris,221,77,193,190,0,681,
Ochotona curzoniae,220,74,201,185,0,680,
Ochotona princeps,225,73,188,194,0,680,
Ochrogaster lunifer,111,54,284,229,0,678,
Ochterus marginatus,121,68,221,260,0,670,
Octodon degus,174,72,220,215,0,681,
Octopus minor,122,51,302,230,0,705,
Octopus ocellatus,114,54,314,211,0,693,
Octopus vulgaris,149,56,312,227,0,744,
Octostigma sinensis,171,70,239,192,0,672,
Ocypode ceratophthalmus,152,77,261,185,0,675,
Odax cyanomelas,243,90,191,159,0,683,
Odaxothrissa losera,207,83,200,194,0,684,
Odaxothrissa vittata,212,93,195,183,0,683,
Odobenus rosmarus,203,78,195,205,0,681,
Odocoileus hemionus,182,83,203,213,0,681,
Odocoileus virginianus,179,83,203,214,2,681,
Odontamblyopus rubicundus,208,91,220,164,0,683,
Odontesthes sp.,226,91,199,168,0,684,
Odontobutis platycephala,199,87,199,198,0,683,
Odontobutis potamophila,220,85,179,200,0,684,
Odontobutis sinensis,192,80,206,206,0,684,
Odontobutis yaluensis,218,85,182,199,0,684,
Odonus niger,230,77,197,179,0,683,
Odorrana margaretae,221,79,210,166,0,676,
Oedalechilus labeo,225,83,198,178,0,684,
Oedalechilus labiosus,232,80,194,178,0,684,
Oedaleus decorus,101,65,244,268,0,678,
Oedipina poelzi,176,73,208,227,0,684,
Oedistoma iliolophum,225,68,180,211,0,684,
Oesophagostomum asperum,40,110,280,170,0,600,
Oesophagostomum columbianum,42,93,289,175,0,599,
Oesophagostomum dentatum,38,107,291,163,1,600,
Oesophagostomum quadrispinulatum,38,94,292,176,0,600,
Ogmocotyle sikae,50,121,248,97,0,516,
Ognevia longipennis,95,63,264,256,0,678,
Okamejei kenojei,213,72,206,193,0,684,
Okapia johnstoni,205,86,178,212,0,681,
Oligodon ningshaanensis,205,87,174,215,0,681,
Omegophora armilla,192,82,223,186,0,683,
Ommastrephes bartramii,161,87,255,190,0,693,
Ommexecha virens,116,68,240,251,0,675,
Onchidella celtica,158,131,216,140,0,645,
Onchocerca flexuosa,41,107,333,104,0,585,
Onchocerca volvulus,38,120,331,96,0,585,
Oncicola luehei,59,192,234,100,0,585,
Oncocephalus breviscutum,108,67,274,262,0,711,
Oncomelania hupensis,101,113,301,181,0,696,
Oncomelania hupensis,109,112,293,182,0,696,
Oncomelania hupensis,116,109,287,184,0,696,
Oncorhynchus clarkii,217,93,202,172,0,684,
Oncorhynchus gorbuscha,220,89,202,173,0,684,
Oncorhynchus keta,222,92,200,170,0,684,
Oncorhynchus kisutch,224,94,192,174,0,684,
Oncorhynchus masou,215,89,204,176,0,684,
Oncorhynchus masou,217,86,203,178,0,684,
Oncorhynchus masou,215,86,204,179,0,684,
Oncorhynchus masou,216,86,204,178,0,684,
Oncorhynchus mykiss,145,61,129,109,0,444,
Oncorhynchus mykiss,218,92,191,171,0,672,
Oncorhynchus nerka,215,87,207,175,0,684,
Oncorhynchus tshawytscha,215,85,199,185,0,684,
Oneirodes thompsoni,235,96,187,166,0,684,
Onisimus nanseni,137,84,254,197,0,672,
Onychiurus orientalis,135,74,281,185,0,675,
Onychodactylus fischeri,131,68,260,225,0,684,
Onychodactylus zhangyapingi,115,56,223,200,0,594,
Onychodactylus zhaoermii,131,68,260,225,0,684,
Onychostoma alticorpus,209,97,174,204,0,684,
Onychostoma barbatulum,194,86,189,215,0,684,
Onychostoma barbatum,204,88,181,211,0,684,
Onychostoma gerlachi,203,93,183,205,0,684,
Onychostoma lini,200,85,185,213,0,683,
Onychostoma macrolepis,199,89,185,210,0,683,
Onychostoma rara,200,93,179,212,0,684,
Onychostoma simum,203,94,183,204,0,684,
Oocatochus rufodorsatus,183,66,186,246,0,681,
Opaepele loihi,180,95,223,177,0,675,
Ophiacantha linea,129,85,250,235,0,699,
Ophiocomina nigra,162,108,195,228,0,693,
Ophiodon elongatus,242,98,174,170,0,684,
Ophiophagus hannah,196,63,182,240,0,681,
Ophiopholis aculeata,152,103,207,222,0,684,
Ophisaurus harti,231,81,176,208,0,696,
Ophisurus macrorhynchos,199,89,194,201,0,683,
Ophiura albida,114,86,252,250,0,702,
Ophiura lutkeni,133,88,244,243,0,708,
Opilio parietinus,126,56,239,254,0,675,
Opisthopatus cinctipes,72,72,288,243,0,675,
Opisthoproctus soleatus,232,89,210,152,0,683,
Opisthorchis felineus,72,135,249,60,0,516,
Opistognathus jacksoniensis,228,94,192,170,0,684,
Oplegnathus fasciatus,232,92,192,167,0,683,
Oplegnathus punctatus,227,83,201,172,0,683,
Oplurus grandidieri,189,62,199,233,0,683,
Opsariichthys bidens,176,118,216,174,0,684,
Opsariichthys uncirostris,183,111,211,179,0,684,
Oratosquilla oratoria,130,80,252,216,0,678,
Orbinia latreillii,192,77,240,202,0,711,
Orcaella brevirostris,190,62,207,219,0,678,
Orcaella heinsohni,197,64,204,216,0,681,
Orchesella villosa,125,77,259,220,0,681,
Orcinus orca,198,67,201,215,0,681,
Orconectes limosus,94,113,286,182,0,675,
Oreamnos americanus,189,75,196,221,0,681,
Orectolobus japonicus,177,78,225,204,0,684,
Oreochromis aureus,225,87,203,169,0,684,
Oreochromis esculentus,227,84,198,175,0,684,
Oreochromis mossambicus,205,89,213,168,0,675,
Oreochromis niloticus,225,87,203,169,0,684,
Oreochromis niloticus,219,87,208,170,0,684,
Oreochromis sp.,223,85,203,173,0,684,
Oreochromis sp.,219,86,207,171,0,683,
Oreochromis variabilis,220,84,206,174,0,684,
Oreoglanis macropterus,221,80,162,221,0,684,
Oreoleuciscus potanini,191,111,204,177,0,683,
Oreomystis bairdi,237,73,167,207,0,684,
Oreopsar bolivianus,244,75,163,202,0,684,
Oreotragus oreotragus,192,76,195,218,0,681,
Orinhippus tibetanus,110,62,235,271,0,678,
Oriolus chinensis,239,83,162,200,0,684,
Orius niger,99,80,258,247,0,684,
Orius sauteri,89,72,271,236,0,668,
Ornithoctonus huwena / Haplopelma schmidti,68,125,300,176,0,669,
Ornithodoros brasiliensis,117,47,255,250,0,669,
Ornithodoros moubata,142,45,245,237,0,669,
Ornithodoros porcinus,132,56,263,218,0,669,
Ornithodoros rostratus,130,48,258,233,0,669,
Ornithorhynchus anatinus,175,76,227,203,0,681,
Oroperipatus sp.,51,119,306,202,0,678,
Orthogonalys pulchella,49,76,339,211,0,675,
Orthriophis taeniurus,191,76,174,240,0,681,
Orussus occidentalis,120,47,287,208,0,662,
Orycteropus afer,182,69,205,225,0,681,
Oryctolagus cuniculus,201,77,202,200,0,680,
Oryx beisa,190,81,194,216,0,681,
Oryx dammah,192,78,194,217,0,681,
Oryx gazella,191,77,194,219,0,681,
Oryx leucoryx,198,78,186,219,0,681,
Oryzias dancena,179,86,236,182,0,683,
Oryzias javanicus,214,103,202,164,0,683,
Oryzias latipes,181,103,222,177,0,683,
Oryzias luzonensis,204,114,203,162,0,683,
Oryzias melastigma,172,87,243,182,0,684,
Oryzias minutillus,187,88,225,183,0,683,
Oryzias sinensis,183,106,218,177,0,684,
Oscaecilia ochrocephala,209,82,184,209,0,684,
Oscarella carmela,96,126,298,218,0,738,
Oscarella lobularis,102,132,288,215,1,738,
Oscarella malakhovi,97,124,297,220,0,738,
Oscarella microlobata,109,137,282,210,0,738,
Oscarella tuberculata,103,132,287,216,0,738,
Oscarella viridis,106,132,285,214,1,738,
Osmerus mordax,219,104,211,150,0,684,
Osteochilus nashii,182,89,195,217,0,683,
Osteochilus salsburyi,169,89,212,214,0,684,
Osteochilus schlegelii,188,86,195,214,0,683,
Osteoglossum bicirrhosum,206,83,216,179,0,684,
Osteolaemus tetraspis,196,75,190,223,0,684,
Ostichthys japonicus,231,90,186,176,0,683,
Ostracion immaculatus,208,77,206,192,0,683,
Ostrea denselamellosa,108,159,256,152,0,675,
Ostrea edulis,100,140,257,172,0,669,
Ostrea lurida,81,123,208,158,0,570,
Ostrinia furnacalis,83,59,290,243,0,675,
Ostrinia nubilalis,82,62,291,240,0,675,
Otis tarda,250,71,169,194,0,684,
Otobius megnini,119,41,273,236,0,669,
Otolemur crassicaudatus,221,77,181,202,0,681,
Ourebia ourebi,212,79,179,211,0,681,
Ovatella vulcani,148,157,221,119,0,645,
Ovibos moschatus,195,75,190,221,0,681,
Ovis ammon,197,78,190,214,0,679,
Ovis aries,191,80,194,214,0,679,
Ovis canadensis,196,75,192,218,0,681,
Ovis orientalis,193,79,193,214,0,679,
Ovis vignei,194,79,192,214,0,679,
Ovophis okinavensis,220,63,191,206,0,680,
Oxuderces dentatus,188,92,225,178,0,683,
Oxya chinensis,90,65,268,255,0,678,
Oxyeleotris lineolata,232,80,193,179,0,684,
Oxyeleotris marmorata,237,83,190,174,0,684,
Oxygymnocypris stewartii,168,105,220,191,0,684,
Oxymonacanthus longirostris,231,96,202,153,0,682,
Oxyopes sertatus,58,96,309,200,0,663,
Oxytate striatipes,56,93,320,194,0,663,
Oxyurichthys formosanus,222,93,202,167,0,684,
Oxyuris equi,45,146,324,86,0,601,
Ozotoceros bezoarticus,177,78,208,218,0,681,
Pachygrapsus crassipes,141,87,273,174,0,675,
Pachyhynobius shangchengensis,138,74,240,232,0,684,
Pachypsylla venusta,108,53,265,249,0,675,
Pacris xizangensis,108,59,250,261,0,678,
Paedocypris progenetica,164,93,204,223,0,684,
Pagellus bogaraveo,215,93,214,162,0,684,
Pagrus auriga,215,92,223,154,0,684,
Pagrus major,225,93,208,157,0,683,
Palaeopropithecus ingens,193,80,206,202,0,681,
Palea steindachneri,197,66,180,241,0,684,
Paleosuchus palpebrosus,249,60,153,222,0,684,
Paleosuchus trigonatus,263,61,142,218,0,684,
Palinurellus wieneckii,151,91,240,196,0,678,
Pallisentis celatus,49,152,250,87,0,538,
Pampus argenteus,175,87,240,182,0,684,
Pampus echinogaster,175,87,240,182,0,684,
Pampus punctatissimus,198,83,210,198,0,689,
Pampus sp.,176,87,239,181,0,683,
Pan paniscus,222,73,182,204,0,681,
Pan troglodytes,224,74,179,204,0,681,
Pandarus rhincodonicus,100,179,245,130,0,654,
Pandion haliaetus,233,73,166,212,0,684,
Pandita sinope,79,55,321,223,0,678,
Pangasianodon gigas,200,79,189,216,0,684,
Pangasianodon hypophthalmus,214,84,176,210,0,684,
Pangasius larnaudii,192,83,198,210,0,683,
Pangasius pangasius,200,84,191,208,0,683,
Pangio anguillaris,208,105,188,183,0,684,
Panonychus citri,47,33,304,237,0,621,
Panonychus ulmi,42,32,318,232,0,624,
Panopea generosa,65,177,305,161,0,708,
Panopea globosa,58,194,317,139,0,708,
Panthera leo,199,86,198,198,0,681,
Panthera onca,198,85,198,200,0,681,
Panthera pardus,191,94,205,191,0,681,
Panthera tigris,193,89,203,196,0,681,
Panthera tigris,191,86,207,197,0,681,
Pantherophis slowinskii,183,67,180,251,0,681,
Pantholops hodgsonii,201,78,186,216,0,681,
Pantodon buchholzi,173,80,228,203,0,684,
Pantoporia hordonia,87,53,316,222,0,678,
Panulirus homarus,149,79,254,196,0,678,
Panulirus japonicus,145,80,258,195,0,678,
Panulirus ornatus,157,86,238,191,0,672,
Panulirus stimpsoni,164,78,242,194,0,678,
Paphia amabilis,92,155,311,180,0,738,
Paphia euglypta,75,150,330,183,0,738,
Paphia textile,87,163,302,165,0,717,
Paphia undulata,75,159,310,173,0,717,
Paphnutius ruficeps,77,99,298,192,0,666,
Papilio bianor,83,56,317,225,0,681,
Papilio helenus,90,52,309,230,0,681,
Papilio maackii,74,55,330,222,0,681,
Papilio machaon,88,56,312,225,0,681,
Papilio maraho,102,49,288,239,0,678,
Papilio polytes,81,54,317,229,0,681,
Papilio syfanius,75,54,329,223,0,681,
Papio anubis,236,65,161,219,0,681,
Papio cynocephalus,239,62,159,221,0,681,
Papio hamadryas,236,64,161,219,0,680,
Papio kindae,236,64,161,220,0,681,
Papio papio,234,68,163,216,0,681,
Papio ursinus,242,64,155,220,0,681,
Papyrocranus congoensis,200,68,206,209,0,683,
Parabotia banarescui,198,95,195,196,0,684,
Parabotia fasciata,180,85,216,203,0,684,
Parabramis pekinensis,203,90,194,197,0,684,
Paracanthobrama guichenoti,184,87,215,198,0,684,
Paracentrotus lividus,171,109,229,190,0,699,
Parachaenichthys charcoti,222,103,196,163,0,684,
Parachanna insignis,226,86,183,188,0,683,
Paracheirodon axelrodi,191,81,237,173,0,682,
Parachromis managuensis,236,92,181,175,0,684,
Paracirrhites arcatus,216,91,200,176,0,683,
Paracladura trichoptera,100,64,287,227,0,678,
Paraconger notialis,220,83,180,200,0,683,
Paracorallium japonicum,112,126,272,198,0,708,
Paracyclopina nana,120,105,263,196,0,684,
Paracymoriza distinctalis,82,52,305,239,0,678,
Paracymoriza prodigalis,87,53,292,243,0,675,
Paradoxornis webbianus,242,74,173,195,0,684,
Parafilaroides normani,33,136,335,90,0,594,
Parafronurus youi,145,89,272,169,0,675,
Paraglypturus tonganus,93,152,303,124,0,672,
Paragonimus westermani,110,139,201,63,0,513,
Paragyrodactylus variegatus,49,60,257,147,0,513,
Parahucho perryi,226,91,191,176,0,684,
Parajapyx emeryanus,158,83,199,235,0,675,
Parajulis poecilepterus,232,92,192,167,0,683,
Parakneria cameronensis,205,81,189,208,0,683,
Paralaubuca typus,186,94,200,203,0,683,
Paralichthys olivaceus,221,90,202,170,0,683,
Paralithodes brevipes,113,79,277,206,0,675,
Paralithodes camtschaticus,118,70,276,211,0,675,
Paraluteres prionurus,214,88,212,169,0,683,
Paramesotriton hongkongensis,180,90,206,208,0,684,
Paramisgurnus dabryanus,191,92,213,188,0,684,
Paramonacanthus choirocephalus,230,93,204,156,0,683,
Paramormyrops gabonensis,220,84,178,202,0,684,
Paramphistomum cervi,50,125,257,84,0,516,
Paraneetroplus synspilus,236,98,181,169,0,684,
Paraneetroplus synspilus,236,98,181,169,0,684,
Paranemertes cf.,59,131,343,108,0,641,
Paranephrops planifrons,149,78,252,196,0,675,
Parantica sita,85,50,306,234,0,675,
Paraplagusia bilineata,178,79,210,190,0,657,
Paraplagusia blochii,184,78,205,190,0,657,
Paraplagusia japonica,186,81,206,182,2,657,
Parapristipoma trilineatum,217,89,207,170,0,683,
Pararasbora moltrechti,180,93,217,194,0,684,
Parargyrops edita,220,87,220,157,0,684,
Parasarpa dudu,90,55,304,229,0,678,
Parascaris univalens,43,135,316,106,0,600,
Parasinilabeo assimilis,183,80,203,218,0,684,
Parastichopus californicus,161,116,215,198,0,690,
Parastichopus nigripunctatus,154,112,218,200,0,684,
Parataeniophorus gulosus,198,90,218,177,0,683,
Paratemnoides elongatus,103,64,268,216,0,651,
Paratenuisentis ambiguus,45,116,249,121,0,531,
Paratilapia polleni,215,91,210,168,0,684,
Paratrioza sinica,124,71,248,232,0,675,
Parazacco spilurus,193,99,212,180,0,684,
Parazen pacificus,225,83,205,170,0,683,
Pardachirus pavoninus,241,90,178,175,0,684,
Pardosa laura,52,86,315,204,0,657,
Pareuchiloglanis gracilicaudata,209,84,174,217,0,684,
Pareuchiloglanis sinensis,214,82,169,219,0,684,
Pareutropius debauwi,207,85,191,200,0,683,
Parnassius apollo,77,53,319,229,0,678,
Parnassius bremeri,83,54,311,230,0,678,
Parnassius cephalus,89,54,303,232,0,678,
Parnassius epaphus,81,53,313,231,0,678,
Parnassius imperator,80,52,312,234,0,678,
Paroreomyza montana,239,73,166,206,0,684,
Parthenos sylvia,88,51,315,224,0,678,
Parupeneus multifasciatus,224,110,189,160,0,683,
Parus major,272,66,153,193,0,684,
Parus venustulus,265,69,149,201,0,684,
Passer domesticus,248,74,156,206,0,684,
Passer montanus,241,81,162,200,0,684,
Pastinachus atrus,190,81,225,188,0,684,
Patiria pectinifera,204,82,210,197,0,693,
Pauropus longiramus,129,63,286,188,0,666,
Pavo cristatus,243,67,181,193,0,684,
Pavo muticus,244,65,180,195,0,684,
Pavona clavus,133,242,382,242,0,999,
Pavona decussata,106,159,284,150,0,699,
Pavoraja nitida,162,63,244,215,0,684,
Pecari tajacu,213,74,164,230,0,681,
Pedetontus silvestrii,131,69,252,226,0,678,
Pedipes pedipes,133,134,260,115,0,642,
Pegasus volitans,218,93,186,186,0,683,
Peirates arcuatus,116,80,243,245,0,684,
Peirates atromaculatus,118,81,248,264,0,711,
Peirates fulvescens,116,79,251,265,0,711,
Peirates lepturoides,115,80,263,253,0,711,
Peirates turpis,117,80,249,265,0,711,
Pelagocephalus marki,236,82,182,183,0,683,
Pelea capreolus,187,76,196,222,0,681,
Pelecinus polyturator,92,41,301,235,0,669,
Pelecus cultratus,178,92,207,207,0,684,
Pellona flavipinnis,228,86,172,198,0,684,
Pellonula leonensis,208,96,198,181,0,683,
Pelobates cultripes,190,83,235,175,0,683,
Pelochelys cantorii,222,61,162,239,0,684,
Pelodiscus sinensis,170,59,206,249,0,684,
Pelodytes cf.,193,85,223,183,0,684,
Pelomedusa subrufa,204,51,207,225,0,687,
Pelophylax cretensis,201,78,235,168,0,682,
Pelophylax cypriensis,207,80,227,168,0,682,
Pelophylax epeiroticus,201,86,235,160,0,682,
Pelophylax kurtmuelleri,205,83,228,166,0,682,
Pelophylax shqipericus,209,79,233,161,0,682,
Pelotretis flavilatus,204,105,207,168,0,684,
Pelteobagrus eupogon,189,79,195,221,0,684,
Pelteobagrus fulvidraco,212,85,178,209,0,684,
Pelteobagrus nitidus,187,80,199,218,0,684,
Pelteobagrus vachellii,187,79,197,221,0,684,
Peltorhamphus novaezeelandiae,209,84,214,177,0,684,
Pelusios castaneus,225,55,189,221,0,690,
Penaeus monodon,121,87,264,203,0,675,
Penelopides panini,251,70,162,201,0,684,
Pennahia argentata,235,88,195,166,0,684,
Pentaceros japonicus,213,97,201,172,0,683,
Peponocephala electra,195,67,204,215,0,681,
Peprilus triacanthus,206,84,205,188,0,683,
Perameles gunnii,181,61,214,225,0,681,
Perca flavescens,220,88,216,160,0,684,
Perca fluviatilis,209,91,220,164,0,684,
Percalates novemaculeata,227,87,204,165,0,683,
Perccottus glenii,168,86,234,194,0,682,
Percilia irwini,175,98,229,181,0,683,
Percina macrolepida,224,93,201,166,0,684,
Percocypris pingi,177,94,199,214,0,684,
Percopsis transmontana,229,95,171,188,0,683,
Perdix dauurica,262,63,176,183,0,684,
Perdix hodgsoniae,266,63,173,182,0,684,
Pericrocotus ethologus,202,67,189,226,0,684,
Perinereis aibuhitensis,148,90,271,192,0,701,
Perinereis nuntia,141,90,258,207,0,696,
Perionyx excavatus,161,81,235,219,0,696,
Periparus ater,271,80,144,189,0,684,
Periplaneta americana,103,74,258,246,0,681,
Periplaneta fuliginosa,101,69,255,255,0,680,
Perna perna,72,111,232,95,0,510,
Perna viridis,66,159,317,172,0,714,
Perodicticus potto,208,67,189,217,0,681,
Peronia peronii,115,110,250,167,0,642,
Pervagor janthinosoma,213,100,223,147,0,683,
Petaurista alborufus,199,75,210,196,0,680,
Petaurista hainana,197,76,211,196,0,680,
Petaurus breviceps,188,77,204,212,0,681,
Petenia splendida,240,88,176,180,0,684,
Pethia conchonius,178,83,201,222,0,684,
Petrobius brevistylis,140,81,250,207,0,678,
Petrocephalus microphthalmus,217,82,189,196,0,684,
Petrocephalus soudanensis,207,84,198,195,0,684,
Petrochromis trewavasae,238,93,194,158,0,683,
Petroica boodang,240,78,177,189,0,684,
Petroica goodenovii,246,68,175,195,0,684,
Petroica phoenicea,250,67,171,196,0,684,
Petrolisthes haswelli,137,79,264,195,0,675,
Petromyzon marinus,165,70,226,218,0,679,
Petroscirtes breviceps,188,84,235,182,0,689,
Petrotilapia nigra,242,88,190,163,0,683,
Phacochoerus africanus,191,69,190,231,0,681,
Phaenacantha marcida,119,71,189,287,0,666,
Phaeognathus hubrichti,148,66,243,227,0,684,
Phaethon rubricauda,269,77,164,186,0,696,
Phalanger vestitus,204,64,184,229,0,681,
Phalangium opilio,128,63,245,239,0,675,
Phalera flavescens,87,55,296,237,0,675,
Phallocryptus tserensodnomi,147,98,246,169,0,660,
Phallusia fumigata,88,204,248,99,0,639,
Phallusia mammillata,119,181,246,93,0,639,
Phanogenia gracilis,89,97,355,149,0,690,
Phascogale tapoatafa,198,69,218,196,0,681,
Phascolarctos cinereus,194,49,199,239,0,681,
Phascolosoma esculenta,167,76,262,191,0,696,
Phasianus colchicus,27,245,68,180,191,542,
Phasianus versicolor,238,69,185,192,0,684,
Phenacobius mirabilis,192,92,208,192,0,684,
Phenacogrammus interruptus,216,80,190,198,0,684,
Philaenus spumarius,84,64,268,244,0,660,
Philanthus triangulum,64,44,293,268,0,669,
Philantomba maxwellii,197,79,188,217,0,681,
Philantomba monticola,195,78,191,217,0,681,
Philodina citrina,29,78,279,169,0,555,
Philometroides sanguineus,42,162,287,205,0,696,
Phlaeoba albonema,108,64,248,258,0,678,
Phobaeticus serratipes,95,58,237,279,0,669,
Phoca fasciata,210,77,189,205,0,681,
Phoca groenlandica,201,80,198,202,0,681,
Phoca largha,207,74,193,207,0,681,
Phoca vitulina,210,76,190,205,0,681,
Phocarctos hookeri,205,85,192,199,0,681,
Phocoena phocoena,201,80,196,204,0,681,
Phoebastria albatrus,249,63,163,209,0,684,
Phoebastria immutabilis,247,69,165,203,0,684,
Phoebastria nigripes,246,67,167,204,0,684,
Phoenicolacerta kulzeri,190,68,210,213,0,681,
Phoenicopterus roseus,245,66,166,207,0,684,
Phoenicurus auroreus,262,80,157,185,0,684,
Pholcus phalangioides,73,144,294,152,0,663,
Pholis crassispina,212,104,209,158,0,683,
Phormia regina,106,70,279,223,0,678,
Phoronopsis harmeri,96,147,286,164,0,693,
Phoxinus eos,179,92,215,197,0,683,
Phoxinus oxycephalus,184,96,207,197,0,684,
Phoxinus percnurus,178,96,215,194,0,683,
Phoxinus percnurus,180,93,215,195,0,683,
Phoxinus percnurus,176,91,217,199,0,683,
Phoxinus phoxinus,173,99,227,185,0,684,
Phoxinus steindachneri,185,107,208,183,0,683,
Phoxinus ujmonensis,175,103,228,178,0,684,
Phractolaemus ansorgii,207,95,190,191,0,683,
Phraortes illepidus,94,65,246,270,0,675,
Phraortes sp.,94,59,234,288,0,675,
Phrynocephalus axillaris,233,80,223,283,0,819,
Phrynocephalus forsythii,193,61,193,235,0,682,
Phrynocephalus grumgrzimailoi,187,75,191,229,0,682,
Phrynocephalus guinanensis,198,74,181,229,0,682,
Phrynocephalus helioscopus,173,76,205,228,0,682,
Phrynocephalus mystaceus,196,69,184,233,0,682,
Phrynocephalus przewalskii,185,72,190,235,0,682,
Phrynocephalus putjatai,232,88,197,254,0,771,
Phrynocephalus versicolor,185,72,190,235,0,682,
Phrynus sp.,160,57,272,180,0,669,
Phthonandria atrilineata,86,55,301,236,0,678,
Phycodurus eques,193,97,227,166,0,683,
Phyllodactylus unctus,262,80,162,177,0,681,
Phylloscopus inornatus,252,73,157,202,0,684,
Physella acuta,108,85,262,175,0,630,
Physemacris variolosa,120,61,228,266,0,675,
Physeter catodon,223,73,176,207,0,679,
Physiculus japonicus,180,94,242,167,0,683,
Physopelta gutta,111,61,206,288,0,666,
Phytoseiulus persimilis,92,40,285,249,0,666,
Phyxioschema suthepium,46,180,271,172,0,669,
Piaractus brachypomus,175,89,202,218,0,684,
Piaractus mesopotamicus,225,88,186,185,0,684,
Pica pica,214,67,187,216,0,684,
Pielomastax zhengi,108,76,251,243,0,678,
Pieris canidia,91,54,293,240,0,678,
Pieris melete,86,52,294,246,0,678,
Pieris rapae,85,52,298,243,0,678,
Piliocolobus badius,190,75,205,211,0,681,
Pimelodus pictus,188,82,194,219,0,683,
Pinctada margaritifera,64,204,251,123,0,642,
Pinctada maxima,81,230,261,121,0,693,
Pinicola enucleator,229,67,169,219,0,684,
Pipa carvalhoi,246,96,180,162,0,684,
Pipistrellus abramus,157,79,231,214,0,681,
Pirata subpiraticus,51,94,307,211,0,663,
Pisaster ochraceus,145,87,257,198,0,687,
Pista cristata,163,74,272,190,0,699,
Pitta nympha,253,61,162,208,0,684,
Placida sp.,140,110,241,169,0,660,
Placopecten magellanicus,80,243,301,126,0,750,
Placozoan sp.,98,109,335,217,0,759,
Placozoan sp.,101,120,341,194,0,756,
Placozoan sp.,98,109,334,218,0,759,
Placozoan sp.,98,110,344,201,0,753,
Plagiognathops microlepis,203,90,197,194,0,684,
Plakina crypta,100,119,298,211,1,729,
Plakina jani,83,124,312,224,1,744,
Plakina monolopha,94,125,301,208,1,729,
Plakina sp.,87,124,306,211,1,729,
Plakina trilopha,77,125,318,224,0,744,
Plakinastrella cf.,90,133,303,218,0,744,
Plakortis halichondrioides,94,123,308,219,0,744,
Plakortis simplex,86,121,313,224,0,744,
Planorbarius corneus,98,78,295,177,0,648,
Platalea leucorodia,240,70,167,207,0,684,
Platalea minor,235,66,171,212,0,684,
Platanista minor,214,63,191,213,0,681,
Platax orbicularis,257,84,171,171,0,683,
Platax teira,257,84,171,171,0,683,
Platemys platycephala,211,54,183,239,0,687,
Platevindex mortoni,115,120,244,166,0,645,
Platichthys stellatus,222,97,207,158,0,684,
Platycephalus indicus,229,94,200,160,0,683,
Platycnemis foliacea,112,85,253,234,0,684,
Platydoras armatulus,213,82,175,214,0,684,
Platygyra carnosus,94,126,317,141,0,678,
Platynereis dumerilii,149,108,239,200,0,696,
Platysmacheilus exiguus,201,97,203,183,0,684,
Platysmacheilus nudiventris,192,92,212,188,0,684,
Platysternon megacephalum,189,66,196,233,0,684,
Platytroctes apus,254,102,164,163,0,683,
Plecoglossus altivelis,247,107,189,141,0,684,
Plecotus auritus,161,87,226,207,0,681,
Plecotus rafinesquii,189,87,195,210,0,681,
Plectorhinchus cinctus,238,91,184,171,0,684,
Plectorhinchus lineatus,241,94,175,174,0,684,
Plectorhinchus orientalis,245,90,170,179,0,684,
Plectorhinchus vittatus,243,89,175,177,0,684,
Plectropomus areolatus,203,81,222,178,0,684,
Plectropomus leopardus,195,87,232,170,0,684,
Plesiobatis daviesi,222,67,207,188,0,684,
Plesiomyzon baotingensis,212,104,188,179,0,683,
Plestiodon egregius,210,85,189,199,0,683,
Plestiodon elegans,211,84,187,202,0,684,
Plethodon cinereus,166,76,231,211,0,684,
Plethodon elongatus,180,68,220,216,0,684,
Plethodon petraeus,183,77,211,213,0,684,
Pleuragramma antarctica,216,108,209,163,0,696,
Pleurogrammus azonus,231,89,200,163,0,683,
Pleurogrammus monopterygius,230,98,198,157,0,683,
Pleuronichthys cornutus,208,87,215,174,0,684,
Plexippus paykulli,64,103,308,191,0,666,
Plutella xylostella,84,56,304,234,0,678,
Pocillopora damicornis,73,111,314,180,0,678,
Pocillopora eydouxi,74,111,315,178,0,678,
Podarcis muralis,179,65,219,218,0,681,
Podarcis siculus,174,64,217,226,0,681,
Podiceps cristatus,258,60,158,208,0,684,
Podoces hendersoni,228,84,177,195,0,684,
Podocnemis unifilis,201,59,198,232,0,690,
Podura aquatica,141,88,236,198,0,663,
Poecile atricapilla,262,65,155,202,0,684,
Poecile palustris,259,70,161,194,0,684,
Poecilia reticulata,184,91,220,189,0,684,
Poecilia sphenops,217,92,204,182,0,695,
Poecillastra laminaris,98,134,301,202,0,735,
Poecilobdella manillensis,75,85,325,247,0,732,
Pogona vitticeps,239,60,165,219,0,683,
Pollachius pollachius,183,86,237,176,0,682,
Pollachius virens,189,86,230,177,0,682,
Pollicipes polymerus,125,84,255,202,0,666,
Polycarpa mytiligera,60,126,292,151,0,629,
Polycheles typhlops,173,74,249,179,0,675,
Polychrus marmoratus,214,59,204,206,0,683,
Polycyathus sp.,78,102,329,169,0,678,
Polydactylus sextarius,204,95,202,183,0,684,
Polylabris halichoeres,70,87,254,159,0,570,
Polymastia littoralis,94,134,305,202,0,735,
Polymixia japonica,199,86,202,197,0,684,
Polymixia lowei,194,85,205,199,0,683,
Polyodon spathula,232,97,174,180,0,683,
Polypedates megacephalus,181,82,232,184,0,679,
Polyplectron bicalcaratum,245,72,184,183,0,684,
Polyplectron germaini,245,70,184,185,0,684,
Polyplectron napoleonis,257,72,175,180,0,684,
Polypterus ansorgii,180,65,202,196,0,643,
Polypterus delhezi,183,82,193,185,0,643,
Polypterus endlicherii,179,65,205,194,0,643,
Polypterus ornatipinnis,186,75,207,216,0,684,
Polypterus palmas,185,69,198,191,0,643,
Polypterus retropinnis,176,71,202,194,0,643,
Polypterus senegalus,177,74,226,206,0,683,
Polypterus teugelsi,177,68,199,199,0,643,
Polypterus weeksii,169,69,203,202,0,643,
Polyspina piosae,220,93,195,175,0,683,
Polystoechotes punctatus,85,70,301,222,0,678,
Polytremis nascens,93,56,322,207,0,678,
Polyura arja,85,56,313,224,0,678,
Polyura nepenthes,83,55,315,225,0,678,
Pomacanthus imperator,211,91,207,175,0,684,
Pomacanthus xanthometopon,214,92,205,173,0,684,
Pomacea canaliculata,90,102,332,175,0,699,
Pomatomus saltatrix,208,100,198,177,0,683,
Pongo abelii,244,68,168,201,0,681,
Pongo pygmaeus,240,70,171,200,0,681,
Ponticola kessleri,193,93,213,185,0,684,
Pontoporia blainvillei,208,72,186,215,0,681,
Porichthys myriaster,203,98,207,175,0,683,
Porites okinawensis,89,153,301,156,0,699,
Porites panamensis,92,153,298,156,0,699,
Porites porites,92,153,298,156,0,699,
Poromitra oscitans,229,92,191,171,0,683,
Porotermes adamsoni,154,79,195,253,0,681,
Porphyrio hochstetteri,248,63,158,215,0,684,
Porphyrio porphyrio,248,59,159,218,0,684,
Portunus pelagicus,145,84,258,191,0,678,
Portunus trituberculatus,140,81,261,196,0,678,
Potamalosa richmondia,214,95,198,177,0,684,
Potamochoerus porcus,199,78,186,218,0,681,
Potamopyrgus antipodarum,122,106,301,167,0,696,
Potamopyrgus estuarinus,123,103,306,164,0,696,
Potamothrissa acutirostris,205,97,203,179,0,684,
Potamothrissa obtusirostris,200,85,206,193,0,684,
Potamotrygon motoro,220,69,189,206,0,684,
Potanthus flavus,92,56,317,210,0,675,
Potomotyphlus kaupii,214,78,173,219,0,684,
Potorous tridactylus,197,68,203,213,0,681,
Praslinia cooperi,189,65,202,228,0,684,
Pratylenchus vulnus,43,101,287,151,0,582,
Prays oleae,92,56,286,238,0,672,
Premnas biaculeatus,219,97,187,180,0,683,
Presbytis melalophos,189,66,207,219,0,681,
Priapulus caudatus,123,104,264,184,0,675,
Priasilpha obscura,122,73,255,222,0,672,
Primolius couloni,245,71,171,196,0,683,
Prionace glauca,168,68,231,217,0,684,
Prionailurus bengalensis,190,81,204,206,0,681,
Prionodon pardicolor,178,79,216,208,0,681,
Pristaulacus compressus,80,34,337,224,0,675,
Pristionchus pacificus,47,95,287,174,0,603,
Pristiophorus japonicus,233,79,184,188,0,684,
Pristipomoides multidens,218,87,193,186,0,684,
Pristis clavata,200,71,202,214,0,687,
Pristis pectinata,197,65,208,214,0,684,
Pristomyrmex punctatus,113,44,301,214,0,672,
Procambarus clarkii,81,102,302,190,0,675,
Procambarus fallax,86,111,294,184,0,675,
Procapra gutturosa,190,75,191,225,0,681,
Procapra przewalskii,189,76,192,224,0,681,
Procavia capensis,209,83,172,217,0,681,
Procecidochares utilis,91,58,294,235,0,678,
Procetichthys kreffti,218,87,203,175,0,683,
Prochilodus lineatus,205,83,201,195,0,684,
Procolobus verus,196,74,204,207,0,681,
Procyon lotor,194,77,208,202,0,681,
Procypris mera,189,92,190,213,0,684,
Procypris rabaudi,186,92,190,215,0,683,
Proechimys longicaudatus,172,77,223,209,0,681,
Proedromys liangshanensis,204,77,183,217,0,681,
Progne chalybea,251,71,156,206,0,684,
Prolemur simus,192,69,221,199,0,681,
Promalactis suzukiella,84,57,307,230,0,678,
Promethichthys prometheus,216,101,195,171,0,683,
Propithecus coquereli,194,76,208,203,0,681,
Propithecus diadema,197,71,207,206,0,681,
Propithecus edwardsi,199,75,206,201,0,681,
Prosadenoporus spectaculum,68,140,381,102,0,691,
Prosopium cylindraceum,209,98,205,172,0,684,
Prosopium williamsoni,211,100,205,168,0,684,
Protaetia brevitarsis,105,70,280,217,0,672,
Protantigius superans,82,51,304,241,0,678,
Proteus anguinus,202,88,197,197,0,684,
Protobothrops cornutus,216,69,174,222,0,681,
Protobothrops dabieshanensis,207,65,179,230,0,681,
Protobothrops jerdonii,216,69,175,221,0,681,
Protobothrops mangshanensis,233,66,165,217,0,681,
Protobothrops maolanensis,219,65,173,224,0,681,
Protobothrops mucrosquamatus,219,61,172,229,0,681,
Protohermes concolorus,114,65,286,210,0,675,
Protonibea diacanthus,241,93,186,164,0,684,
Protophormia terraenovae,103,73,283,219,0,678,
Protoplasa fitchii,97,71,290,220,0,678,
Protopterus aethiopicus,198,85,214,184,1,682,
Protopterus annectens,195,84,215,188,0,682,
Protopterus dolloi,196,92,206,188,0,682,
Protosalanx hyalocranius,229,93,192,170,0,684,
Protostrongylus rufescens,34,115,312,139,0,600,
Prumna arctica,107,63,255,253,0,678,
Przewalskium albirostris,176,79,212,214,0,681,
Psacothea hilaris,103,67,281,224,0,675,
Psammobates pardalis / Stigmochelys pardalis,202,59,180,240,0,681,
Psenes cyanophrys,185,89,213,196,0,683,
Psenes pellucidus,190,91,205,197,0,683,
Psenopsis anomala,219,96,205,163,0,683,
Psephurus gladius,237,88,167,192,0,684,
Psetta maxima,207,94,229,166,0,696,
Psettodes erumei,252,85,192,154,0,683,
Pseudacysta perseae,97,49,255,265,0,666,
Pseudaesopia japonica,232,88,192,172,0,684,
Pseudalutarius nasicornis,241,87,197,157,0,682,
Pseudaspius leptocephalus,204,111,191,177,0,683,
Pseudecheneis sulcata,192,76,197,219,0,684,
Pseudexostoma yunnanensis,225,83,161,215,0,684,
Pseudhymenochirus merlini,192,87,208,197,0,684,
Pseudobagrus albomarginatus,183,81,200,220,0,684,
Pseudobagrus brevicaudatus,192,82,191,219,0,684,
Pseudobagrus brevicorpus,202,92,185,205,0,684,
Pseudobagrus emarginatus,198,80,185,221,0,684,
Pseudobagrus ondon,199,87,186,212,0,684,
Pseudobagrus tokiensis,210,86,180,208,0,684,
Pseudobagrus trilineatus,187,81,201,215,0,684,
Pseudobagrus truncatus,196,83,187,218,0,684,
Pseudobagrus ussuriensis,195,83,190,216,0,684,
Pseudobalistes flavimarginatus,253,89,175,166,0,683,
Pseudobrama simoni,184,89,210,201,0,684,
Pseudocarcharias kamoharai,169,75,229,211,0,684,
Pseudocarcinus gigas,132,78,267,197,0,674,
Pseudocellus gertschi,145,52,204,271,0,672,
Pseudocellus pearsei,146,51,205,269,4,675,
Pseudocentrotus depressus,168,94,220,208,0,690,
Pseudochauhanea macrorchis,68,97,263,139,0,567,
Pseudocheirus peregrinus,193,71,193,222,0,679,
Pseudocorticium jarrei,87,123,303,223,2,738,
Pseudogarypus banksi,88,52,275,227,0,642,
Pseudogobio esocinus,187,87,210,200,0,684,
Pseudogobius javanicus,215,95,213,161,0,684,
Pseudogyrinocheilus prochilus,179,89,204,211,0,683,
Pseudohemiculter dispar,197,94,201,192,0,684,
Pseudohynobius flavomaculatus,141,75,237,231,0,684,
Pseudohynobius jinfo,147,77,233,227,0,684,
Pseudohynobius puxiongensis,152,82,226,224,0,684,
Pseudois nayaur,196,72,191,222,0,681,
Pseudois schaeferi,192,72,193,224,0,681,
Pseudolabrus eoethinus,238,91,190,165,0,684,
Pseudolabrus sieboldi,235,100,191,157,0,683,
Pseudolaubuca engraulis,202,112,200,170,0,684,
Pseudolaubuca sinensis,196,97,201,190,0,684,
Pseudoleistes guirahuro,249,76,159,200,0,684,
Pseudoleistes virescens,247,73,162,202,0,684,
Pseudoleptodeira latifasciata,161,63,210,247,0,681,
Pseudolestes mirabilis,154,93,192,239,0,678,
Pseudomonacanthus peroni,246,84,182,171,0,683,
Pseudomys chapmani,170,69,214,228,0,681,
Pseudonestor xanthophrys,238,69,166,211,0,684,
Pseudoniphargus daviui,145,74,272,181,0,672,
Pseudopentaceros richardsoni,216,101,202,164,0,683,
Pseudopentaceros wheeleri,216,92,198,176,1,683,
Pseudoplatystoma corruscans,207,80,176,221,0,684,
Pseudoplatystoma magdaleniatum,211,88,173,212,0,684,
Pseudopodoces humilis,261,74,160,189,0,684,
Pseudopterogorgia bipinnata,109,120,281,198,0,708,
Pseudopungtungia nigra,188,94,213,189,0,684,
Pseudopungtungia tenuicorpus,179,91,225,189,0,684,
Pseudorasbora elongata,165,83,237,199,0,684,
Pseudorasbora parva,183,99,222,180,0,684,
Pseudorasbora pumila,189,89,221,185,0,684,
Pseudorca crassidens,192,65,210,217,0,684,
Pseudorhombus cinnamoneus,216,105,192,171,0,684,
Pseudoryx nghetinhensis,190,74,191,226,0,681,
Pseudosiderastrea formosa,88,149,302,160,0,699,
Pseudosiderastrea tayami,90,148,300,161,0,699,
Pseudotmethis rubimarginis,115,66,246,251,0,678,
Pseudotrapelus sinaitus,226,80,167,217,0,690,
Pseudotriakis microdon,152,76,253,203,0,684,
Pseudotriton ruber,174,66,219,225,0,684,
Pseudotropheus crabro,240,88,191,164,0,683,
Pseudoxya diminuta,99,63,256,260,0,678,
Psilorhynchus homaloptera,192,98,213,181,0,684,
Psilorhynchus sucatio,209,97,213,164,0,683,
Psococerastis albimaculata,138,62,260,221,0,681,
Psoroptes cuniculi,92,119,304,157,0,672,
Pteraclis aesticola,207,86,221,169,0,683,
Pteragogus flagellifer,230,106,200,147,0,683,
Pterapogon kauderni,207,88,220,168,0,683,
Pterocaesio tile,233,91,184,175,0,683,
Pterocnemia pennata,264,73,165,182,0,684,
Pterocryptis cochinchinensis,219,77,178,210,0,684,
Pterodroma brevirostris,225,66,184,209,0,684,
Pteroglossus azara,271,70,164,179,0,684,
Pterois miles,212,106,182,183,0,683,
Pterois volitans,207,102,188,187,0,684,
Pteromys volans,188,74,222,197,0,681,
Pteronarcys princeps,125,81,268,204,0,678,
Pteronotus parnellii,209,78,187,207,0,681,
Pteronotus rubiginosus,211,75,183,212,0,681,
Pterophyllum scalare,219,91,205,169,0,684,
Pteroplatytrygon violacea,202,79,210,193,0,684,
Pteropus alecto,195,87,183,216,0,681,
Pteropus dasymallus,197,84,179,221,0,681,
Pteropus scapulatus,192,86,187,216,0,681,
Pteropus vampyrus,198,80,179,224,0,681,
Pterothrissus gissu,207,95,183,198,0,683,
Ptilocaulis walpersi,82,100,340,213,0,735,
Ptilopachus petrosus,236,62,179,207,0,684,
Ptychidio jordani,183,89,201,211,0,684,
Ptychobarbus dipogon,183,101,200,200,0,684,
Ptychobarbus kaznakovi,178,103,206,197,0,684,
Ptychochromoides katria,231,87,191,175,0,684,
Ptychoptera sp.,117,69,272,220,0,678,
Pucrasia macrolopha,248,66,178,192,0,684,
Pudu mephistophiles,167,73,217,224,0,681,
Pudu puda,165,77,221,218,0,681,
Puma concolor,195,76,197,213,0,681,
Pungitius kaibarae,221,89,200,174,0,684,
Pungitius pungitius,214,91,211,168,0,684,
Pungitius sinensis,214,92,211,167,0,684,
Pungtungia herzi,189,97,208,190,0,684,
Puntius chalakkudiensis,164,85,218,217,0,684,
Puntius denisonii,170,83,209,222,0,684,
Puntius semifasciolatus,181,88,203,212,0,684,
Puntius snyderi,181,87,201,215,0,684,
Puntius tetrazona,176,85,200,223,0,684,
Puntius ticto,179,81,201,223,0,684,
Pupa strigosa,127,127,228,178,0,660,
Pupilla muscorum,108,84,275,181,0,648,
Pusa caspica,212,80,188,201,0,681,
Pusa hispida,207,76,192,206,0,681,
Pusa sibirica,213,78,187,203,0,681,
Pycnonotus melanicterus,232,68,173,214,0,687,
Pycnonotus sinensis,241,69,160,214,0,684,
Pycnonotus taivanus,240,67,161,216,0,684,
Pyganodon grandis,86,176,290,156,0,708,
Pygathrix cinerea,181,70,207,223,0,681,
Pygathrix cinerea,179,72,209,221,0,681,
Pygathrix nemaeus,181,68,207,225,0,681,
Pygathrix nigripes,184,76,206,215,0,681,
Pygocentrus nattereri,238,94,178,173,0,683,
Pygoplites diacanthus,211,89,206,178,0,684,
Pygoscelis antarcticus,252,68,164,212,0,696,
Pyramidella dolabrata,107,125,253,155,0,640,
Pyrgacris descampsi,133,68,229,245,0,675,
Pyrgilauda blanfordi,230,71,171,212,0,684,
Pyrgilauda davidiana,233,69,170,212,0,684,
Pyrocoelia rufa,103,55,263,249,0,670,
Pyrophorus divergens,152,75,213,235,0,675,
Pyrrhocorax graculus,212,72,179,221,0,684,
Pyrrhocorax pyrrhocorax,219,73,177,215,0,684,
Pyrrhula pyrrhula,236,69,173,206,0,684,
Python molurus,205,68,181,227,0,681,
Python regius,207,71,185,218,0,681,
Pythonichthys microphthalmus,218,87,184,194,0,683,
Pyura gangelion,65,127,280,158,0,630,
Pyxidea mouhotii,189,73,197,225,0,684,
Qinlingacris taibaiensis,95,62,262,259,0,678,
Quadrula quadrula,65,211,317,115,0,708,
Quasipaa boulengeri,200,74,222,186,0,682,
Quasipaa spinosa,195,72,228,187,0,682,
Quasipaa yei,206,79,219,178,0,682,
Quiscalus quiscula,257,73,155,199,0,684,
Rachycentron canadum,186,91,210,197,0,684,
Radix auricularia,109,88,256,189,0,642,
Radix balthica,102,83,280,177,0,642,
Radix swinhoei,111,90,256,170,0,627,
Radopholus similis,21,54,334,191,0,600,
Rafetus swinhoei,201,66,173,244,0,684,
Raiamas guttatus,197,99,202,185,0,683,
Raiamas senegalensis,185,107,206,186,0,684,
Raja pulchra,219,77,202,186,0,684,
Raja rhina,212,76,203,193,0,684,
Rallina eurizonoides,232,62,167,223,0,684,
Ramphotyphlops braminus,217,68,193,203,0,681,
Ramulus hainanense,126,68,222,262,0,678,
Ramulus irregulariterdentatus,96,67,248,264,0,675,
Rana catesbeiana,206,75,227,171,0,679,
Rana cf.,212,83,218,169,0,682,
Rana chosenica,219,81,215,167,0,682,
Rana dybowskii,229,81,200,172,0,682,
Rana ishikawae,234,76,204,162,0,676,
Rana kunyuensis,194,68,235,185,0,682,
Rana nigromaculata,223,78,211,170,0,682,
Rana plancyi,218,83,215,166,0,682,
Rangifer tarandus,175,83,207,216,0,681,
Ranina ranina,138,86,279,171,0,674,
Ranodon sibiricus,136,67,236,245,0,684,
Ranzania laevis,230,95,187,171,0,683,
Rapana venosa,111,94,310,177,4,696,
Raphicerus campestris,189,79,197,216,0,681,
Rapisma xizangense,77,63,318,217,0,675,
Rapisma zayuanum,77,65,318,215,0,675,
Rasbora borapetensis,175,79,207,219,0,680,
Rasbora daniconius,182,89,198,214,0,683,
Rasbora steineri,179,72,212,218,0,681,
Rasbora trilineata,191,75,199,215,0,680,
Rasbora vaterifloris,164,84,223,212,0,683,
Rattus exulans,186,69,202,224,0,681,
Rattus fuscipes,197,74,190,220,0,681,
Rattus leucopus,197,71,187,226,0,681,
Rattus lutreolus,193,71,193,224,0,681,
Rattus niobe,201,75,183,222,0,681,
Rattus norvegicus,195,75,192,219,0,681,
Rattus norvegicus,195,73,192,221,0,681,
Rattus praetor,197,76,189,219,0,681,
Rattus rattus,184,74,206,217,0,681,
Rattus sordidus,187,71,199,224,0,681,
Rattus tanezumi,188,71,200,222,0,681,
Rattus tunneyi,187,71,197,226,0,681,
Rattus villosissimus,188,72,196,225,0,681,
Ratufa bicolor,187,76,212,206,0,681,
Ravinia pernix,107,73,287,211,0,678,
Redunca arundinum,187,79,193,222,0,681,
Redunca fulvorufula,193,80,190,218,0,681,
Regulus calendula,219,77,183,205,0,684,
Reinhardtius hippoglossoides,212,94,212,165,0,683,
Reishia clavigera,124,113,301,158,0,696,
Remiz consobrinus,290,74,140,180,0,684,
Rena humilis,246,71,138,225,0,680,
Renilla muelleri,111,116,281,200,0,708,
Repomucenus curvicornis,198,115,213,157,0,683,
Reticulitermes aculabialis,149,73,185,271,0,678,
Reticulitermes chinensis,156,77,178,267,0,678,
Reticulitermes flavipes,158,75,174,271,0,678,
Reticulitermes hageni,161,80,172,265,0,678,
Reticulitermes santonensis,158,75,174,271,0,678,
Reticulitermes virginicus,154,77,177,270,0,678,
Retinia pseudotsugaicola,102,62,291,223,0,678,
Retropinna retropinna,212,115,228,128,0,683,
Rexea nakamurai,221,98,196,168,0,683,
Rexea solandri,219,97,188,180,0,684,
Rezinkovia echinata,107,122,303,203,0,735,
Rhabdopleura compacta,103,187,410,143,0,843,
Rhabdosargus sarba,215,92,219,158,0,684,
Rhacophorus schlegelii,172,68,206,176,0,622,
Rhagophthalmus lufengensis,85,56,264,270,0,675,
Rhagophthalmus ohbai,92,55,265,263,0,675,
Rhamphochromis esox,241,88,191,163,0,683,
Rhea americana,255,71,170,188,0,684,
Rhigonema thysanophora,73,136,290,96,0,595,
Rhinatrema bivittatum,214,91,184,194,0,683,
Rhincodon typus,178,69,224,213,0,684,
Rhinecanthus aculeatus,227,87,195,174,0,683,
Rhineura floridana,205,68,172,235,0,680,
Rhinobatos hynnicephalus,196,72,205,211,0,684,
Rhinobatos schlegelii,194,70,209,211,0,684,
Rhinoceros sondaicus,205,72,188,216,0,681,
Rhinoceros unicornis,208,66,185,222,0,681,
Rhinochimaera pacifica,210,79,209,186,0,684,
Rhinogobio cylindricus,201,96,198,189,0,684,
Rhinogobio typus,188,85,209,202,0,684,
Rhinogobio ventralis,190,89,209,196,0,684,
Rhinogobius giurinus,230,98,192,164,0,684,
Rhinolophus ferrumequinum,210,85,193,193,0,681,
Rhinolophus ferrumequinum,210,86,193,192,0,681,
Rhinolophus formosae,214,78,193,196,0,681,
Rhinolophus luctus,202,74,195,210,0,681,
Rhinolophus macrotis,218,88,182,193,0,681,
Rhinolophus monoceros,214,81,188,198,0,681,
Rhinolophus pumilus,213,85,187,196,0,681,
Rhinomugil nasutus,188,88,219,189,0,684,
Rhinomuraena quaesita,193,102,215,173,0,683,
Rhinophrynus dorsalis,224,93,187,180,0,684,
Rhinophylla pumilio,161,73,236,211,0,681,
Rhinopithecus avunculus,188,71,205,217,0,681,
Rhinopithecus bieti,191,69,202,219,0,681,
Rhinopithecus bieti,191,68,202,220,0,681,
Rhinopithecus bieti,191,68,202,220,0,681,
Rhinopithecus brelichi,187,69,205,220,0,681,
Rhinopithecus roxellana,191,75,205,210,0,681,
Rhinopithecus strykeri,188,69,205,219,0,681,
Rhipicephalus australis,85,55,309,223,0,672,
Rhipicephalus geigyi,77,52,309,234,0,672,
Rhipicephalus microplus,83,55,307,227,0,672,
Rhipicephalus sanguineus,98,59,302,207,0,666,
Rhizomys pruinosus,178,61,223,219,0,681,
Rhizomys sinensis,184,59,229,209,0,681,
Rhodactis indosinensis,95,150,289,165,0,699,
Rhodactis mussoides,94,150,290,165,0,699,
Rhodactis sp.,92,149,293,165,0,699,
Rhodeus lighti,204,95,209,176,0,684,
Rhodeus ocellatus,192,90,216,186,0,684,
Rhodeus ocellatus,192,88,213,191,0,684,
Rhodeus sericeus,195,95,207,187,0,684,
Rhodeus shitaiensis,195,90,218,181,0,684,
Rhodeus sinensis,194,93,212,185,0,684,
Rhodeus suigensis,209,97,207,171,0,684,
Rhodeus uyekii,199,87,212,186,0,684,
Rhodopsona rubiginosa,96,55,300,227,0,678,
Rhodosoma turcicum,61,149,308,91,0,609,
Rhopaea magnicornis,105,66,289,212,0,672,
Rhopalocaulis grandidieri,111,133,254,120,0,618,
Rhopalomyia pomum,75,40,284,273,0,672,
Rhyacichthys aspro,227,102,181,173,0,683,
Rhyacionia leptotubula,69,36,209,162,1,477,
Rhyacotriton variegatus,142,68,240,234,0,684,
Rhynchactis macrothrix,215,96,214,158,0,683,
Rhynchocypris kumgangensis / Phoxinus keumkang,194,105,201,184,0,684,
Rhynchocypris lagowskii,188,108,207,180,0,683,
Rhyncholestes raphanurus,180,65,212,224,0,681,
Rhynchopelates oxyrhynchus,226,89,197,171,0,683,
Rhynchopsitta terrisi,231,68,182,202,0,683,
Rhynochetos jubatus,240,62,175,207,0,684,
Ricania marginalis,112,56,210,300,0,678,
Ricinoides karschii,173,59,208,232,0,672,
Ricordea florida,96,152,287,164,0,699,
Ricordea yuma,93,157,294,155,0,699,
Ridgeia piscesae,185,82,252,171,0,690,
Riftia pachyptila,156,70,270,191,0,687,
Rimicaris exoculata,174,91,231,179,0,675,
Rimicaris kairei,174,89,232,180,0,675,
Riptortus pedestris,105,62,266,239,0,672,
Risoba prominens,84,55,311,228,0,678,
Rita rita,191,75,189,228,0,683,
Robinsia catherinae,196,93,200,191,0,680,
Roboastra europaea,131,108,234,196,0,669,
Romanogobio tenuicorpus,200,101,202,181,0,684,
Romanomermis culicivorax,48,51,282,174,0,555,
Romanomermis iyengari,57,61,278,183,0,579,
Romanomermis nielseni,53,58,274,167,0,552,
Rondeletia loricata,207,89,214,173,0,683,
Rondotia menciana,103,54,278,243,0,678,
Rotaria rotatoria,37,105,289,166,0,597,
Rousettus aegyptiacus,216,78,181,206,0,681,
Rucervus duvaucelii,175,82,210,214,0,681,
Rucervus eldi / Rucervus eldii,188,80,202,211,0,681,
Rudarius ercodes,196,104,219,164,0,683,
Rupicapra pyrenaica,195,81,190,215,0,681,
Rupicapra rupicapra,195,79,190,217,0,681,
Rusa alfredi,178,75,212,216,0,681,
Rusa timorensis,175,80,213,213,0,681,
Rusa unicolor,177,79,211,214,0,681,
Ruspolia dubia,127,76,269,203,0,675,
Rutilia goerlingiana,104,67,278,226,0,675,
Ruvettus pretiosus,226,94,187,176,0,683,
Sacalia bealei,192,65,193,234,0,684,
Sacalia quadriocellata,198,68,195,235,0,696,
Saccoglossus kowalevskii,211,76,245,155,0,687,
Saccopharynx lavenbergi,188,103,208,184,0,683,
Saccostrea mordax,88,137,266,187,0,678,
Sagamichthys abei,256,102,164,162,0,684,
Sagmariasus verreauxi,153,96,251,178,0,678,
Saguinus oedipus,205,72,194,210,0,681,
Saiga tatarica,179,73,202,227,0,681,
Saimiri boliviensis,206,59,199,217,0,681,
Saimiri boliviensis,207,59,198,217,0,681,
Saimiri oerstedii,205,60,198,218,0,681,
Saimiri sciureus,207,59,198,217,0,681,
Salamandrella keyserlingii,142,75,247,220,0,684,
Salamandrella tridactyla,148,74,238,224,0,684,
Salangichthys microdon,241,107,188,147,0,683,
Salanx ariakensis,245,95,187,156,0,683,
Salarias fasciatus,230,91,193,169,0,683,
Saldula arsenjevi,114,77,232,288,0,711,
Salinator rhamphidia,130,116,243,154,0,643,
Salminus brasiliensis,213,94,200,177,0,684,
Salmo salar,225,80,196,183,0,684,
Salmo trutta,233,86,192,173,0,684,
Salmo trutta,234,86,191,173,0,684,
Salmostoma bacaila,189,97,205,192,0,683,
Salvelinus alpinus,219,94,204,167,0,684,
Salvelinus curilus,221,93,199,171,0,684,
Salvelinus fontinalis,220,93,205,166,0,684,
Salvelinus leucomaenis,221,93,204,166,0,684,
Samaris cristatus,204,76,212,192,0,684,
Samariscus latus,200,85,224,175,0,684,
Samia canningi,86,53,311,228,0,678,
Samia cynthia,86,52,311,229,0,678,
Sander canadensis,221,91,210,159,0,681,
Sander lucioperca,222,86,211,165,0,684,
Sarcocheilichthys lacustris,186,98,210,190,0,684,
Sarcocheilichthys nigripinnis,196,99,204,185,0,684,
Sarcocheilichthys parvus,207,105,196,176,0,684,
Sarcocheilichthys sinensis,185,91,212,196,0,684,
Sarcocheilichthys variegatus,199,105,203,177,0,684,
Sarcophaga africa,107,73,285,213,0,678,
Sarcophaga crassipalpis,102,74,286,216,0,678,
Sarcophaga impatiens,124,71,258,225,0,678,
Sarcophaga melanura,121,73,263,204,0,661,
Sarcophaga peregrina,112,73,270,208,0,663,
Sarcophaga portschinskyi,106,67,274,214,0,661,
Sarcophaga similis,109,67,269,216,0,661,
Sarcophilus harrisii,184,65,224,208,0,681,
Sardina pilchardus,211,123,196,153,0,683,
Sardinella albella,217,119,190,158,0,684,
Sardinella maderensis,216,105,189,173,0,683,
Sardinops melanostictus,212,115,200,156,0,683,
Sargocentron rubrum,231,86,190,177,0,684,
Sarotherodon melanotheron,227,92,201,164,0,684,
Sasakia charonda,87,55,293,243,0,678,
Sasakia charonda,87,55,293,243,0,678,
Sasakia funebris,81,54,301,242,0,678,
Saturnia boisduvalii,84,51,322,220,0,677,
Saundersilarus saundersi,258,73,162,191,0,684,
Saurida microlepis,234,87,203,159,0,683,
Saurida umeyoshii,230,82,204,168,0,684,
Saurida undosquamis,229,90,204,161,0,684,
Saurida wanieso,230,92,201,161,0,684,
Saurogobio dabryi,185,96,210,193,0,684,
Saurogobio dumerili,210,103,203,168,0,684,
Savalia savaglia,132,163,257,146,1,699,
Saxidomus purpuratus,100,172,350,194,0,816,
Scalicus amiscus,212,95,205,171,0,683,
Scapanulus oweni,179,77,208,217,0,681,
Scapharca broughtonii,46,118,228,133,0,525,
Scapharca kagoshimensis,56,147,298,174,0,675,
Scaphiodonichthys acanthopterus,178,92,196,218,0,684,
Scaphirhynchus cf.,234,98,174,177,0,683,
Scartelaos histophorus,203,93,213,174,0,683,
Scarus forsteni,221,101,193,169,0,684,
Scarus ghobban,218,96,195,175,0,684,
Scarus rubroviolaceus,221,102,192,169,0,684,
Scarus schlegeli,216,113,193,162,0,684,
Scathophaga stercoraria,90,73,290,225,0,678,
Scatophagus argus,210,94,208,171,0,683,
Sceloporus occidentalis,204,78,189,212,0,683,
Schedophilus velaini,230,99,193,162,0,684,
Schedorhinotermes breinli,180,75,164,262,0,681,
Schismatorhynchos nukta,196,87,187,213,0,683,
Schistocerca gregaria,121,67,240,250,0,678,
Schistometopum gregorii,141,59,247,237,0,684,
Schistosoma haematobium,52,74,239,160,0,525,
Schistosoma japonicum,50,107,252,110,0,519,
Schistosoma mansoni,46,119,240,117,0,522,
Schistosoma mekongi,44,83,262,133,0,522,
Schistosoma spindale,48,94,239,141,0,522,
Schistura balteata,201,79,201,203,0,684,
Schizaphis graminum,78,34,296,246,0,654,
Schizopyge niger,182,104,197,201,0,684,
Schizopygopsis kialingensis,172,101,217,194,0,684,
Schizopygopsis malacanthus,168,101,220,195,0,684,
Schizopygopsis pylzovi,170,102,218,194,0,684,
Schizothorax biddulphi,178,104,201,200,0,683,
Schizothorax chongi,182,106,197,199,0,684,
Schizothorax davidi,182,110,197,195,0,684,
Schizothorax dolichonema,182,107,197,198,0,684,
Schizothorax esocinus,185,96,197,206,0,684,
Schizothorax labiatus,185,96,197,206,0,684,
Schizothorax lantsangensis,186,111,193,194,0,684,
Schizothorax lissolabiatus,182,107,197,198,0,684,
Schizothorax macropogon,186,105,191,202,0,684,
Schizothorax plagiostomus,187,98,190,209,0,684,
Schizothorax prenanti,180,108,199,197,0,684,
Schizothorax progastus,185,97,197,205,0,684,
Schizothorax pseudoaksaiensis,191,100,189,204,0,684,
Schizothorax waltoni,184,104,194,201,0,683,
Schmidtea mediterranea,60,96,372,108,0,636,
Sciaenops ocellatus,245,90,185,164,0,684,
Scirpophaga incertulas,124,58,250,246,0,678,
Scirtothrips dorsalis,97,78,259,208,0,642,
Sciurus vulgaris,181,74,223,202,0,680,
Sclerolinum brattstromi,166,72,252,206,0,696,
Scleronephthya gracillimum,119,121,270,198,0,708,
Scleropages formosus,247,82,171,184,0,684,
Scleropages jardinii,236,94,192,162,0,684,
Sclerophasma paresisense,109,74,260,232,0,675,
Scobinichthys granulatus,219,95,205,164,0,683,
Scolecomorphus vittatus,147,72,239,225,0,683,
Scoliodon macrorhynchos,171,67,229,217,0,684,
Scolopax rusticola,240,67,178,199,0,684,
Scomber australasicus,214,89,206,175,0,684,
Scomber colias,223,87,198,176,0,684,
Scomber japonicus,221,89,202,172,0,684,
Scomber scombrus,224,86,190,184,0,684,
Scomberomorus cavalla,223,90,182,189,0,684,
Scomberomorus munroi,209,96,205,174,0,684,
Scomberomorus munroi,217,85,195,187,0,684,
Scomberomorus niphonius,214,90,195,185,0,684,
Scomberomorus semifasciatus,211,95,203,175,0,684,
Scombrops boops,225,86,194,178,0,683,
Scopelengys tristis,246,96,179,163,0,684,
Scopelogadus mizolepis,234,83,200,167,0,684,
Scorpis lineolata,211,87,211,174,0,683,
Scortum barcoo,243,96,188,157,0,684,
Scutigera coleoptrata,146,70,255,202,0,673,
Scutigerella causeyae,115,65,291,201,0,672,
Scutopus ventrolineatus,134,84,270,199,0,687,
Scyliorhinus canicula,165,77,239,203,0,684,
Scylla olivacea,146,85,263,184,0,678,
Scylla paramamosain,123,74,287,194,0,678,
Scylla serrata,132,84,283,179,0,678,
Scylla tranquebarica,120,72,296,190,0,678,
Scyllarides latus,152,82,268,179,0,681,
Sebastes inermis,198,96,207,183,0,684,
Sebastes koreanus,216,86,198,184,0,684,
Sebastes longispinis,210,91,204,179,0,684,
Sebastes oblongus,215,90,197,182,0,684,
Sebastes owstoni,214,92,194,184,0,684,
Sebastes schlegelii,216,93,196,179,0,684,
Sebastiscus marmoratus,210,90,197,187,0,684,
Seepiophila jonesi,181,70,256,180,0,687,
Selar crumenophthalmus,212,86,207,179,0,684,
Selenops bursarius,58,104,306,195,0,663,
Semele scabra,82,209,275,145,0,711,
Semirossia patagonica,127,56,292,218,0,693,
Semisulcospira libertina,126,113,297,160,0,696,
Semnopithecus entellus,189,83,202,207,0,681,
Sepia aculeata,120,62,289,222,0,693,
Sepia apama,119,58,284,232,0,693,
Sepia esculenta,124,74,295,200,0,693,
Sepia latimanus,110,62,285,236,0,693,
Sepia lycidas,104,55,299,235,0,693,
Sepia officinalis,118,62,306,207,0,693,
Sepia pharaonis,93,57,316,227,0,693,
Sepiella inermis,113,55,301,224,0,693,
Sepiella japonica,122,59,291,221,0,693,
Sepioteuthis lessoniana,135,64,291,203,0,693,
Seriatopora caliendrum,82,112,302,182,0,678,
Seriatopora hystrix,83,112,300,183,0,678,
Serinus albogularis,246,63,162,213,0,684,
Serinus dorsostriatus,240,62,170,212,0,684,
Seriola dumerili,224,107,190,163,0,684,
Seriola lalandi,221,102,190,171,0,684,
Seriola quinqueradiata,228,108,185,163,0,684,
Seriola rivoliana,220,98,197,169,0,684,
Seriolella porosa,225,88,186,185,0,684,
Serrivomer beanii,198,100,189,196,0,683,
Serrivomer sector,197,100,189,197,0,683,
Sesamia inferens,91,55,301,231,0,678,
Setaria digitata,37,113,350,82,0,582,
Setipinna taty,199,83,200,202,0,684,
Sewellia lineolata,199,95,204,185,0,683,
Shinisaurus crocodilurus,209,64,191,216,0,680,
Shinkaia crosnieri,131,69,285,193,0,678,
Shirakiacris shirakii,119,80,250,229,0,678,
Sialis hamata,94,64,285,232,0,675,
Sibogagorgia cauliflora,115,123,272,198,0,708,
Siboglinum fiordicum,131,59,315,171,0,676,
Sibon nebulatus,183,68,189,241,0,681,
Sibynophis chinensis,186,79,186,230,0,681,
Sibynophis collaris,185,79,187,230,0,681,
Sicamugil cascasia,197,102,216,169,0,684,
Sicyopterus japonicus,212,95,194,182,0,683,
Sicyopterus lagocephalus,205,96,202,180,0,683,
Siderastrea radians,93,150,299,157,0,699,
Siganus canaliculatus,233,91,184,174,0,682,
Siganus fuscescens,232,91,186,173,0,682,
Siganus guttatus,227,82,192,182,0,683,
Siganus puellus,230,91,193,169,0,683,
Siganus unimaculatus,233,86,186,178,0,683,
Siganus vulpinus,232,85,187,179,0,683,
Sigmops gracilis,233,83,202,166,0,684,
Sillago aeolus,220,113,196,155,0,684,
Sillago asiatica,215,115,197,157,0,684,
Sillago indica,212,114,207,151,0,684,
Sillago sihama,208,113,208,155,0,684,
Silurus asotus,203,83,199,198,0,683,
Silurus glanis,205,90,189,200,0,684,
Silurus lanzhouensis,215,92,186,191,0,684,
Silurus meridionalis,211,87,190,196,0,684,
Silurus soldatovi,203,84,199,198,0,684,
Simenchelys parasitica,178,103,211,191,0,683,
Simias concolor,183,74,211,213,0,681,
Simosyrphus grandicornis,85,67,304,219,0,675,
Sinanodonta woodiana,63,173,306,160,0,702,
Sinentomon erythranum,56,95,378,119,0,648,
Sinibotia superciliaris,180,94,203,207,0,684,
Sinibrama macrops,201,94,195,194,0,684,
Sinibrama taeniatus,193,93,202,196,0,684,
Siniperca chuatsi,224,86,195,179,0,684,
Siniperca chuatsi,224,86,195,179,0,684,
Siniperca chuatsi,223,86,196,179,0,684,
Siniperca knerii,224,87,193,180,0,684,
Siniperca obscura,233,88,189,173,0,683,
Siniperca roulei,221,88,199,176,0,684,
Siniperca scherzeri,233,89,189,173,0,684,
Siniperca scherzeri,233,89,189,172,0,683,
Siniperca undulata,224,86,195,179,0,684,
Sinobdella sinensis,217,77,198,191,0,683,
Sinochlora longifissa,137,76,261,201,0,675,
Sinocyclocheilus altishoulderus,180,83,202,219,0,684,
Sinocyclocheilus anophthalmus,191,100,194,199,0,684,
Sinocyclocheilus anshuiensis,187,103,189,205,0,684,
Sinocyclocheilus furcodorsalis,184,98,192,207,0,681,
Sinocyclocheilus grahami,189,108,194,193,0,684,
Sinocyclocheilus rhinocerous,174,86,206,218,0,684,
Sinogastromyzon puliensis,205,90,201,188,0,684,
Sinogastromyzon sichangensis,206,92,199,187,0,684,
Sinonovacula constricta,73,141,327,158,0,699,
Sinotmethis brachypterus,117,69,242,250,0,678,
Sinularia peculiaris,108,117,283,200,0,708,
Siphlonurus immanis,127,80,275,196,0,678,
Siphonaria gigas,161,98,205,193,0,657,
Siphonaria pectinata,103,101,279,180,0,663,
Siphonodentalium lobatum,112,71,253,198,0,634,
Siphonops annulatus,156,65,228,234,0,683,
Sipunculus nudus,218,91,215,164,0,688,
Sirembo imberbis,207,106,183,188,0,684,
Sirthenea flavipes,121,80,244,275,0,720,
Sitobion avenae,78,35,287,247,0,647,
Sitta carolinensis,223,72,172,217,0,684,
Sivaloka damnosus,99,53,225,275,0,652,
Sladenia gardineri,217,89,196,181,0,683,
Smaug warreni,228,67,183,205,0,683,
Sminthopsis crassicaudata,193,78,221,189,0,681,
Sminthopsis douglasi,197,67,213,204,0,681,
Sminthurus viridis,129,94,252,203,0,678,
Smithornis sharpei,266,62,166,190,0,684,
Sogatella furcifera,111,58,258,228,0,655,
Solea ovata,233,84,191,176,0,684,
Solea senegalensis,228,86,204,166,0,684,
Solecurtus divaricatus,97,230,354,165,0,846,
Solemya velum,78,131,322,165,0,696,
Solen grandis,77,219,426,154,0,876,
Solen strictus,89,225,417,145,0,876,
Solenaia carinatus,72,205,300,131,0,708,
Solenaia oleivora,80,203,292,133,0,708,
Solenopsis geminata,133,45,277,211,0,666,
Solenopsis invicta,133,47,272,214,0,666,
Solenopsis richteri,134,49,271,212,0,666,
Solenosmilia variabilis,95,158,294,152,0,699,
Solenostomus cyanopterus,201,85,215,183,0,684,
Solenostomus paradoxus,207,88,209,179,0,683,
Soletellina diphos,69,188,321,142,0,720,
Somniosus pacificus,189,71,222,202,0,684,
Songmachilis xinxiangensis,122,77,275,204,0,678,
Sooglossus thomasseti,207,73,198,206,0,684,
Sorex cylindricauda,170,71,216,224,0,681,
Sorex tundrensis,177,80,209,215,0,681,
Sorex unguiculatus,186,73,204,221,0,684,
Sorubim cuspicaudus,194,78,184,228,0,684,
Sousa chinensis,193,68,205,215,0,681,
Southwellina hispida,37,159,213,128,0,537,
Spalacopus cyanus,180,73,219,209,0,681,
Spalax carmeli,205,66,172,238,0,681,
Sparus aurata,220,93,209,161,0,683,
Spathius agrili,47,58,339,225,0,669,
Sphaerius sp.,74,67,289,245,0,675,
Sphaerotheriidae sp.,140,56,249,228,0,673,
Spheniscus demersus,253,62,159,210,0,684,
Sphenodon punctatus,199,89,178,218,0,684,
Sphenophorus sp.,109,61,287,212,0,669,
Sphinx morio,77,57,307,237,0,678,
Sphoeroides annulatus,245,80,179,179,0,683,
Sphoeroides pachygaster,211,91,208,173,0,683,
Sphoeroides parvus,224,88,193,178,0,683,
Sphoeroides testudineus,245,78,178,182,0,683,
Sphyraena barracuda,223,85,186,189,0,683,
Sphyraena japonica,208,110,201,164,0,683,
Sphyrna lewini,185,70,215,214,0,684,
Sphyrna zygaena,170,71,231,212,0,684,
Spicara maena,204,100,214,165,0,683,
Spilogale putorius,179,74,215,213,0,681,
Spilonota lechriaspis,73,56,320,229,0,678,
Spilornis cheela,259,70,156,199,0,684,
Spinachia spinachia,175,83,244,182,0,684,
Spindasis takanonis,76,48,314,240,0,678,
Spinibarbus caldwelli,188,89,192,215,0,684,
Spinibarbus denticulatus,187,90,193,214,0,684,
Spinibarbus hollandi,183,86,198,217,0,684,
Spinibarbus sinensis,173,94,201,216,0,684,
Spirocerca lupi,37,110,338,100,0,585,
Spirometra decipiens,54,114,265,83,0,516,
Spirometra erinaceieuropaei,54,114,265,83,0,516,
Spodoptera exigua,88,61,295,234,0,678,
Spodoptera litura,85,58,302,233,0,678,
Spratelloides delicatulus,236,124,183,140,0,683,
Spratelloides gracilis,194,105,221,163,0,683,
Sprattus antipodum,221,103,194,166,0,684,
Sprattus muelleri,219,103,196,166,0,684,
Sprattus sprattus,203,106,211,163,0,683,
Squalidus argentatus,207,88,195,194,0,684,
Squalidus gracilis,199,94,204,186,0,683,
Squalidus wolterstorffi,209,91,193,190,0,683,
Squaliobarbus curriculus,202,89,191,202,0,684,
Squaliobarbus curriculus,199,90,194,201,0,684,
Squalogadus modificatus,203,81,230,169,0,683,
Squalus acanthias,169,70,235,210,0,684,
Squatina formosa,168,78,240,198,0,684,
Squatina japonica,167,72,240,205,0,684,
Squatina nebulosa,167,79,241,197,0,684,
Squilla empusa,142,89,257,190,0,678,
Squilla mantis,126,87,272,193,0,678,
Squilloides leptosquilla,140,78,258,202,0,678,
Steganacarus magnus,82,49,349,170,0,650,
Steinernema carpocapsae,49,93,308,150,0,600,
Stemonidium hypomelas,184,95,200,204,0,683,
Stenella attenuata,193,69,205,214,0,681,
Stenella coeruleoalba,190,67,208,216,0,681,
Stenodus leucichthys,227,99,186,172,0,684,
Stenopirates sp.,73,46,285,277,0,681,
Stenopus hispidus,126,86,252,208,0,672,
Stephanolepis cirrhifer,199,96,220,168,0,683,
Stercorarius maccormicki,240,65,178,201,0,684,
Sterechinus neumayeri,157,104,240,189,0,690,
Stereochilus marginatus,202,81,201,200,0,684,
Sternotherus carinatus,185,57,193,246,0,681,
Sthenoteuthis oualaniensis,139,73,272,209,0,693,
Stichopathes lutkeni,95,115,258,168,0,636,
Stichophthalma louisa,95,52,297,237,0,681,
Stichopus horrens,164,92,225,203,0,684,
Stichopus sp.,166,95,223,200,0,684,
Stictopleurus subviridis,101,67,252,249,0,669,
Stiphodon alcedo,212,93,203,175,0,683,
Strelkovimermis spiculatus,62,61,272,199,0,594,
Streptocephalus sirindhornae,141,93,249,177,0,660,
Streptopelia chinensis,242,70,175,197,0,684,
Striacosta albicosta,93,55,304,226,0,678,
Striatobalanus amaryllis,99,67,279,221,0,666,
Strigamia maritima,160,80,190,236,0,666,
Strigops habroptilus,243,58,179,204,0,684,
Strombus gigas,128,104,301,163,0,696,
Strongylocentrotus droebachiensis,162,119,231,172,0,684,
Strongylocentrotus intermedius,166,113,234,177,0,690,
Strongylocentrotus pallidus,160,115,234,181,0,690,
Strongylocentrotus purpuratus,164,112,234,186,0,696,
Strongylura anastomella,197,71,233,183,0,684,
Strongylus equinus,35,96,302,167,0,600,
Strongylus vulgaris,39,103,292,169,0,603,
Struthio camelus,245,66,174,199,0,684,
Sturnira tildae,220,68,181,212,0,681,
Sturnus cineraceus,262,74,150,198,0,684,
Sturnus nigricollis,257,75,150,202,0,684,
Sturnus sericeus,266,76,148,194,0,684,
Sturnus tristis / Acridotheres tristis,262,81,153,188,0,684,
Styela plicata,87,131,265,144,0,627,
Stylatula elongata,119,117,274,198,0,708,
Stylephorus chordatus,206,82,209,186,0,683,
Stylochyrus rarior,123,52,257,234,0,666,
Stylophora pistillata,84,109,305,180,0,678,
Suberites domuncula,89,142,300,204,0,735,
Succinea putris,75,72,283,212,15,657,
Sufflamen fraenatum,241,82,189,171,0,683,
Suncus murinus,156,69,241,215,0,681,
Sundasalanx mekongensis,206,84,212,181,0,683,
Sundasalanx praecox,209,90,204,181,0,684,
Sundasalanx sp.,212,89,208,175,0,684,
Sus barbatus,198,72,181,230,0,681,
Sus cebifrons,198,67,181,235,0,681,
Sus celebensis,196,67,183,235,0,681,
Sus scrofa,192,70,187,232,0,681,
Sus scrofa,194,71,185,231,0,681,
Sus scrofa,192,70,187,232,0,681,
Sus verrucosus,197,68,180,236,0,681,
Sylvia atricapilla,221,67,175,221,0,684,
Sylvia crassirostris,245,68,161,210,0,684,
Sylvicapra grimmia,205,78,182,216,0,681,
Sylvicola fenestralis,104,80,290,204,0,678,
Sylviparus modestus,244,72,170,198,0,684,
Symphalangus syndactylus,220,66,183,212,0,681,
Symphurus plagiusa,217,103,181,156,0,657,
Symphylella sp.,143,70,224,236,0,673,
Symphysodon discus,221,85,194,184,0,684,
Symsagittifera roscoffensis,78,85,323,216,0,702,
Synanceia verrucosa,187,85,221,191,0,684,
Synaphobranchus kaupii,196,84,193,210,0,683,
Syncerus caffer,197,83,180,221,0,681,
Synchiropus splendidus,171,87,228,197,0,683,
Synechogobius ommaturus,203,94,216,171,0,684,
Syngamus trachea,43,125,285,147,0,600,
Syngnathus schlegeli,217,85,217,164,0,683,
Synodontis schoutedeni,218,77,175,213,0,683,
Synodus variegatus,213,112,198,161,0,684,
Synthliboramphus antiquus,236,66,185,197,0,684,
Sypharochiton pelliserpentis,103,93,308,201,0,705,
Sypharochiton sinclairi,113,84,303,205,0,705,
Syrmaticus ellioti,235,68,187,194,0,684,
Syrmaticus humiae,234,68,188,194,0,684,
Syrmaticus reevesii,251,72,173,188,0,684,
Syrmaticus soemmerringi,232,68,193,191,0,684,
Tachybaptus novaehollandiae,261,56,154,213,0,684,
Tachybaptus ruficollis,259,57,157,211,0,684,
Tachycineta albilinea,242,68,160,214,0,684,
Tachycineta albiventer,243,73,161,207,0,684,
Tachycineta bicolor,244,64,158,218,0,684,
Tachycineta cyaneoviridis,239,64,165,216,0,684,
Tachycineta euchrysea,250,67,156,211,0,684,
Tachycineta leucorrhoa,244,66,157,217,0,684,
Tachycineta meyeni,246,65,158,215,0,684,
Tachycineta stolzmanni,241,72,164,207,0,684,
Tachycineta thalassina,238,73,163,210,0,684,
Tachyglossus aculeatus,193,75,209,204,0,681,
Tachypleus tridentatus,116,51,277,231,0,675,
Tachysurus fulvidraco,212,85,178,209,0,684,
Tadorna ferruginea,254,72,158,200,0,684,
Tadorna tadorna,256,80,153,195,0,684,
Taenia arctos,35,102,273,106,0,516,
Taenia asiatica,36,99,270,111,0,516,
Taenia crassiceps,36,93,268,116,0,513,
Taenia crocutae,37,101,270,108,0,516,
Taenia hydatigena,39,109,257,111,0,516,
Taenia laticollis,39,91,261,125,0,516,
Taenia madoquae,35,87,271,123,0,516,
Taenia martis,36,77,283,117,0,513,
Taenia multiceps,42,106,265,103,0,516,
Taenia ovis,40,103,263,110,0,516,
Taenia pisiformis,45,86,255,124,0,510,
Taenia regis,47,112,246,111,0,516,
Taenia saginata,35,103,274,104,0,516,
Taenia serialis,37,94,266,119,0,516,
Taenia solium,49,87,257,123,0,516,
Taenia taeniaeformis,45,90,248,136,0,519,
Taenia twitchelli,34,84,280,115,0,513,
Taeniopygia guttata,236,71,157,220,0,684,
Taeniura lymma,219,69,193,203,0,684,
Taeniura meyeni,208,70,205,201,0,684,
Takifugu chinensis,227,85,186,185,0,683,
Takifugu chrysops,224,88,189,182,0,683,
Takifugu exascurus,223,85,188,187,0,683,
Takifugu fasciatus,229,88,184,183,0,684,
Takifugu flavidus,228,84,186,186,0,684,
Takifugu niphobles,224,84,189,186,0,683,
Takifugu oblongus,225,86,189,183,0,683,
Takifugu obscurus,229,88,184,182,0,683,
Takifugu ocellatus,228,88,186,181,0,683,
Takifugu pardalis,223,89,191,180,0,683,
Takifugu poecilonotus,226,85,186,186,0,683,
Takifugu porphyreus,222,85,192,184,0,683,
Takifugu rubripes,226,86,187,185,0,684,
Takifugu snyderi,220,84,193,186,0,683,
Takifugu stictonotus,219,83,193,188,0,683,
Takifugu vermicularis,219,84,196,184,0,683,
Takifugu xanthopterus,223,81,192,187,0,683,
Takydromus sexlineatus,167,71,219,223,0,680,
Takydromus tachydromoides,195,78,203,204,0,680,
Takydromus wolteri,180,70,221,210,0,681,
Talismania bifurcata,239,108,180,157,0,684,
Talpa europaea,188,79,195,219,0,681,
Tamandua tetradactyla,194,77,179,231,0,681,
Tamias sibiricus,167,67,222,224,0,680,
Tamiops swinhoei,188,67,201,225,0,681,
Tamolanica tamolana,111,62,261,244,0,678,
Tanaecia julii,77,55,313,232,1,678,
Tanakia lanceolata,203,98,212,171,0,684,
Tanakia limbata,206,107,205,166,0,684,
Tanaocerus koebelei,138,71,216,246,1,672,
Tanichthys albonubes,168,95,225,195,0,683,
Tanystylum orbiculare,63,63,304,235,0,665,
Tapirus indicus,194,69,199,219,0,681,
Taractes asper,234,84,188,177,0,683,
Tarentola mauritanica,229,75,160,217,0,681,
Tarragoilus diuturnus,164,79,223,212,0,678,
Tarsipes rostratus,187,69,209,214,0,679,
Tarsius bancanus,186,67,206,222,0,681,
Tarsius dentatus,186,71,206,218,0,681,
Tarsius lariang,181,70,209,221,0,681,
Tarsius syrichta,176,80,215,210,0,681,
Tarsius wallacei,181,71,208,221,0,681,
Taurotragus derbianus,202,80,183,216,0,681,
Taxidea taxus,207,72,194,208,0,681,
Tegillarca granosa,55,206,264,123,0,648,
Tegula brunnea,112,123,300,164,0,699,
Teinopalpus aureus,86,52,306,234,0,678,
Teinopalpus imperialis,96,53,296,233,0,678,
Teladorsagia circumcincta,41,101,280,178,0,600,
Telamonia vlijmi,59,93,303,208,0,663,
Teleogryllus emma,120,65,260,239,0,684,
Telmatobius bolivianus,193,75,228,188,0,684,
Temnopleurus hardwickii,147,102,228,213,0,690,
Tenebrio molitor,139,77,212,244,0,672,
Tenualosa ilisha,204,110,194,176,0,684,
Tenualosa thibaudeaui,202,105,198,179,0,684,
Tenualosa toli,205,102,200,177,0,684,
Tenuibranchiurus glypticus,180,82,228,185,0,675,
Teratoscincus keyserlingii,225,71,188,196,0,680,
Teratoscincus roborowskii,231,83,179,188,0,681,
Terebellides stroemii,160,83,276,183,0,702,
Terebra dimidiata,98,120,311,167,0,696,
Terebratalia transversa,89,197,294,107,0,687,
Terebratulina retusa,206,78,219,185,0,688,
Termes hospes,155,76,175,272,0,678,
Testudo graeca,191,63,189,241,0,684,
Testudo horsfieldii,200,66,182,236,0,684,
Testudo kleinmanni,193,63,189,239,0,684,
Testudo marginata,188,60,193,243,0,684,
Tethya actinia,73,115,305,242,0,735,
Tetrabrachium ocellatum,105,172,311,117,0,705,
Tetracerus quadricornis,191,71,202,217,0,681,
Tetraclita japonica,148,68,242,208,0,666,
Tetractenos glaber,243,93,175,172,0,683,
Tetragnatha maxillosa,76,104,288,195,0,663,
Tetragonurus atlanticus,196,93,220,174,0,683,
Tetragonurus cuvieri,211,93,204,175,0,683,
Tetraleurodes acaciae,84,122,321,124,0,651,
Tetrancistrum nebulosi,82,98,217,113,0,510,
Tetranychus cinnabarinus,45,42,338,194,0,619,
Tetranychus kanzawai,44,43,340,192,0,619,
Tetranychus ludeni,43,42,341,193,0,619,
Tetranychus malaysiensis,48,45,349,177,0,619,
Tetranychus phaselus,50,38,340,191,0,619,
Tetranychus pueraricola,55,39,334,191,0,619,
Tetranychus truncatus,43,40,333,203,0,619,
Tetranychus urticae,51,37,335,196,0,619,
Tetraodon biocellatus,245,89,180,169,0,683,
Tetraodon cutcutia,219,81,197,186,0,683,
Tetraodon mbu,240,80,176,187,0,683,
Tetraodon miurus,228,88,188,179,0,683,
Tetraodon nigroviridis,237,86,186,175,0,684,
Tetraodon palembangensis,246,74,180,183,0,683,
Tetraogallus tibetanus,250,71,171,192,0,684,
Tetraophasis obscurus,262,69,165,188,0,684,
Tetraophasis szechenyii,261,68,166,189,0,684,
Tetraphalerus bruchi,163,67,185,260,0,675,
Tetrapturus angustirostris,229,85,197,173,0,684,
Tetrapturus audax,240,82,185,177,0,684,
Tetrastemma olgarum,64,147,359,122,0,692,
Tetrastes bonasia,235,75,186,188,0,684,
Tetrastes sewerzowi,238,76,186,184,0,684,
Tetrix japonica,101,64,234,273,0,672,
Tetrodontophora bielanensis,128,70,268,212,0,678,
Tevnia jerichonana,187,74,250,179,0,690,
Thalamita crenata,136,88,262,189,0,675,
Thalassarche melanophrys,247,67,164,206,0,684,
Thalassenchelys sp.,206,94,188,195,0,683,
Thalassina kelanang,158,84,231,205,0,678,
Thamnaconus hypargyreus,223,97,205,159,0,684,
Thamnaconus modestus,226,88,202,167,0,683,
Thamnaconus tessellatus,226,99,202,157,0,684,
Thaumamermis cosgrovei,67,86,236,145,0,534,
Thaumatichthys pagidostomus,209,83,204,187,0,683,
Thelazia callipaeda,29,121,310,122,0,582,
Thenus orientalis,188,91,224,178,0,681,
Thermobia domestica,168,72,238,195,0,673,
Thermophis zhaoermii,212,78,166,225,0,681,
Theropithecus gelada,228,59,170,224,0,681,
Thitarodes gonggaensis,85,54,300,239,0,678,
Thitarodes pui,102,57,284,235,0,678,
Thitarodes renzhiensis,86,58,299,235,0,678,
Thorius n.,196,100,203,185,0,684,
Thraupis episcopus,249,75,160,200,0,684,
Thraupis sayaca,247,73,162,202,0,684,
Threskiornis aethiopicus,227,65,176,216,0,684,
Thrinchus schrenkii,129,68,233,248,0,678,
Thrips imaginis,96,67,248,246,0,657,
Thryonomys swinderianus,175,58,213,235,0,681,
Thryssa baelama,196,102,196,190,0,684,
Thulinius sp.,147,61,240,212,0,660,
Thunnus alalunga,207,93,199,185,0,684,
Thunnus albacares,214,88,193,188,1,684,
Thunnus atlanticus,216,87,191,190,0,684,
Thunnus maccoyii,210,87,190,188,9,684,
Thunnus obesus,213,88,190,186,7,684,
Thunnus orientalis,209,93,197,185,0,684,
Thunnus thynnus,216,89,191,188,0,684,
Thunnus tonggol,214,89,193,188,0,684,
Thylacinus cynocephalus,182,66,225,208,0,681,
Thylacodes squamigerus,150,130,260,159,0,699,
Thylamys elegans,185,69,215,211,0,680,
Thymallus arcticus,200,90,208,186,0,684,
Thymallus grubii,203,91,210,180,0,684,
Thymallus thymallus,200,87,212,185,0,684,
Thynnichthys polylepis,184,82,195,222,0,683,
Thyridosmylus langii,113,73,275,217,0,678,
Thyropygus sp.,165,68,216,227,0,676,
Thyrsitoides marleyi,223,91,199,170,0,683,
Tigriopus californicus,82,177,252,176,0,687,
Tigriopus japonicus,105,189,238,153,0,685,
Tilodon sexfasciatum,218,91,211,163,0,683,
Timelaea maculata,85,52,308,233,0,678,
Tinamus major,231,59,184,210,0,684,
Tinca tinca,176,82,212,214,0,684,
Tirumala limniace,88,54,307,232,0,681,
Todarodes pacificus,119,69,285,220,0,693,
Todiramphus sanctus,260,63,159,202,0,684,
Tomistoma schlegelii,193,75,201,227,0,696,
Tonatia saurophila,192,66,201,222,0,681,
Topsentia ophiraphidites,95,127,288,225,0,735,
Tor putitora,195,91,191,207,0,684,
Tor sinensis,190,94,195,205,0,684,
Tor tambroides,190,93,195,206,0,684,
Torquigener brevipennis / Torquigener brevipinnis,231,82,197,173,0,683,
Torquigener hypselogeneion,223,85,199,176,0,683,
Torquigener pleurogramma,234,93,188,168,0,683,
Toxascaris leonina,37,136,314,113,0,600,
Toxocara canis,49,138,307,104,0,598,
Toxocara cati,48,130,310,110,0,598,
Toxocara malaysiensis,43,140,310,105,0,598,
Toxolasma parvus,73,201,313,124,0,711,
Toxotes chatareus,231,91,184,177,0,683,
Trachemys scripta,191,70,196,227,0,684,
Trachidermus fasciatus,234,102,186,161,0,683,
Trachinops taeniatus,207,95,220,162,0,684,
Trachinotus blochii,215,86,201,182,0,684,
Trachinotus carolinus,217,87,196,184,0,684,
Trachinotus ovatus,214,87,198,185,0,684,
Trachipterus trachypterus,202,84,231,167,0,684,
Trachurus japonicus,222,86,201,175,0,684,
Trachurus trachurus,224,86,200,174,0,684,
Trachypachus holmbergi,89,60,288,238,0,675,
Trachypithecus cristatus,192,78,208,203,0,681,
Trachypithecus francoisi,185,71,215,210,0,681,
Trachypithecus germaini,189,80,211,201,0,681,
Trachypithecus hatinhensis,189,71,209,212,0,681,
Trachypithecus johnii,199,77,197,208,0,681,
Trachypithecus obscurus,183,77,215,206,0,681,
Trachypithecus pileatus,189,71,206,215,0,681,
Trachypithecus shortridgei,189,71,206,215,0,681,
Trachypithecus vetulus,196,74,199,212,0,681,
Trachyrincus murrayi,201,77,235,170,0,683,
Tragelaphus angasii,203,83,176,219,0,681,
Tragelaphus eurycerus,202,77,180,222,0,681,
Tragelaphus imberbis,207,83,176,215,0,681,
Tragelaphus oryx,203,77,181,220,0,681,
Tragelaphus scriptus,208,76,178,219,0,681,
Tragelaphus spekii,199,83,185,214,0,681,
Tragelaphus strepsiceros,196,80,187,218,0,681,
Tragopan caboti,244,75,174,191,0,684,
Tragopan temminckii,242,73,176,193,0,684,
Tragulus kanchil,197,77,187,220,0,681,
Traulia szetschuanensis,102,64,254,258,0,678,
Tregellasia leucops,250,75,164,195,0,684,
Tremarctos ornatus,186,85,208,202,0,681,
Trematocranus placodon,239,88,191,165,0,683,
Triacanthodes anomalus,212,90,199,182,0,683,
Triacanthus biaculeatus,210,116,205,152,0,683,
Triaenodon obesus,186,67,216,215,0,684,
Trialeurodes vaporariorum,91,134,299,130,0,654,
Triatoma dimidiata,165,78,223,218,0,684,
Tribolium audax,129,64,239,240,0,672,
Tribolium castaneum,143,68,232,229,0,672,
Tribolium confusum,140,68,235,229,0,672,
Tribolodon brandtii,198,107,195,184,0,684,
Tribolodon hakonensis,200,104,193,187,0,684,
Tribolodon nakamurai,198,106,195,185,0,684,
Tribolodon sachalinensis,202,112,191,179,0,684,
Trichechus manatus,200,94,199,186,0,679,
Trichinella britovi,210,57,213,351,0,831,
Trichinella murrelli,216,55,208,352,0,831,
Trichinella nativa,192,55,225,342,0,814,
Trichinella nelsoni,212,62,210,350,0,834,
Trichinella papuae,218,77,207,327,0,829,
Trichinella pseudospiralis,211,62,209,349,0,831,
Trichinella spiralis,211,57,209,354,0,831,
Trichinella zimbabwensis,209,67,219,340,0,835,
Trichiurus japonicus,211,100,196,177,0,684,
Trichiurus lepturus,215,99,189,181,0,684,
Trichobatrachus robustus,225,65,207,185,0,682,
Trichobilharzia regenti,39,120,272,85,0,516,
Trichocera bimacula,127,79,277,195,0,678,
Trichogaster leerii,202,91,216,175,0,684,
Trichogaster trichopterus,177,84,228,194,0,683,
Tricholepidion gertschi,127,80,249,222,0,678,
Trichophthalma punctata,129,70,250,226,0,675,
Trichoplax adhaerens,105,132,336,201,0,774,
Trichostrongylus axei,38,117,270,175,0,600,
Trichostrongylus vitrinus,36,94,280,187,0,597,
Trichosurus vulpecula,194,61,193,233,0,681,
Trichuris discolor,144,99,334,251,0,828,
Trichuris ovis,159,81,310,275,0,825,
Trichuris suis,146,90,285,289,0,810,
Trichuris trichiura,170,83,285,290,0,828,
Tricula hortensis,85,98,317,196,0,696,
Tridacna squamosa,144,252,399,288,0,1083,
Tridentiger barbatus,197,90,214,183,0,684,
Tridentiger bifasciatus,196,111,209,165,0,681,
Trigoniophthalmus alternatus,129,72,242,235,0,678,
Trilophidia annulata,95,64,255,264,0,678,
Trimeresurus albolabris,205,59,190,227,0,681,
Trimusculus reticulatus,122,123,252,146,0,643,
Trinectes maculatus,220,90,200,174,0,684,
Trinomys dimidiatus,191,74,201,215,0,681,
Trioceros melleri,182,68,181,247,0,678,
Triodon macropterus,242,92,184,165,0,683,
Triodontophorus brevicauda,38,108,278,176,0,600,
Trionyx triunguis,237,57,150,240,0,684,
Triops australiensis,110,82,274,206,0,672,
Triops cancriformis,151,80,233,208,0,672,
Triops longicaudatus,127,88,268,189,0,672,
Triphysa phryne,102,58,298,220,0,678,
Triploid megalobrama,201,92,194,197,0,684,
Triplophysa anterodorsalis,187,102,225,170,0,684,
Triplophysa bleekeri,184,101,226,173,0,684,
Triplophysa robusta,173,100,227,184,0,684,
Triplophysa rosa,182,95,208,199,0,684,
Triplophysa siluroides,171,101,230,182,0,684,
Triplophysa stoliczkai,177,95,231,181,0,684,
Triplophysa strauchii,175,95,235,179,0,684,
Triso dermopterus,218,101,181,184,0,684,
Tristira magellanica,113,60,251,246,0,670,
Tritonia diomedea,125,107,263,171,0,666,
Triturus carnifex,211,90,188,195,0,684,
Triturus cristatus,205,90,195,194,0,684,
Triturus dobrogicus,202,93,197,192,0,684,
Triturus karelinii,203,91,199,191,0,684,
Triturus macedonicus,211,90,190,193,0,684,
Triturus marmoratus,201,89,196,198,0,684,
Triturus pygmaeus,200,89,196,199,0,684,
Trixiphichthys weberi,238,90,186,169,0,683,
Troglophilus neglectus,119,70,284,205,0,678,
Trogon viridis,225,70,183,206,0,684,
Tropheus duboisi,241,91,191,160,0,683,
Tropheus moorii,237,94,195,157,0,683,
Tropidophis haetianus,193,79,183,226,0,681,
Tropisternus sp.,107,73,244,248,0,672,
Trypaea australiensis,115,106,287,167,0,675,
Trypauchen vagina,211,86,216,170,0,683,
Tscherskia triton,209,84,190,198,0,681,
Tubastraea coccinea,97,153,292,157,0,699,
Tubulipora flabellaris,68,87,278,200,0,633,
Tupaia belangeri,211,95,179,196,0,681,
Turbinaria peltata,93,149,295,162,0,699,
Turdus hortulorum,260,70,158,196,0,684,
Turdus migratorius,253,79,161,191,0,684,
Tursiops aduncus,188,67,210,216,0,681,
Tursiops australis,195,70,204,212,0,681,
Tursiops truncatus,194,72,204,211,0,681,
Tylerius spinosissimus,239,93,183,168,0,683,
Tylochromis polylepis,221,89,202,172,0,684,
Tylorrhynchus heterochaetus,139,85,204,175,0,603,
Tylototriton verrucosus,199,85,182,218,0,684,
Tympanoctomys barrerae,178,71,212,220,0,681,
Typhlonectes natans,227,100,159,197,0,683,
Typhlops reticulatus,201,77,190,213,0,681,
Tyrophagus putrescentiae,92,102,334,144,0,672,
Tyspanodes hypsalis,86,56,315,215,0,672,
Ulomoides dermestoides,148,68,237,219,0,672,
Umalia orientalis,143,82,271,179,0,675,
Umbra pygmaea,212,79,213,179,0,683,
Uncia uncia,196,85,199,201,0,681,
Uncinaria sanguinis,41,100,292,167,0,600,
Unio douglasiae,76,164,310,152,0,702,
Unio pictorum,64,179,314,145,0,702,
Unionicola foili,137,43,256,227,0,663,
Unionicola parkeri,125,48,212,278,0,663,
Upogebia major,152,82,242,199,0,675,
Upogebia pusilla,127,82,268,198,0,675,
Upogebia yokoyai,133,77,256,209,0,675,
Uraeotyphlus cf.,184,59,217,223,0,683,
Uraeotyphlus gansi,193,69,205,217,0,684,
Uragus sibiricus,243,73,164,204,0,684,
Urechis caupo,196,95,233,220,0,744,
Urechis unicinctus,188,93,238,225,0,744,
Urochela quadrinotata,106,61,255,247,0,669,
Urocissa erythrorhyncha,227,66,171,220,0,684,
Uroctonus mordax,67,110,319,170,0,666,
Urocyon cinereoargenteus,190,91,204,196,0,681,
Uromastyx benti,222,76,158,230,0,686,
Uroplatus fimbriatus,227,82,200,171,0,680,
Uropsilus soricipes,164,73,223,221,0,681,
Uropsilus sp.,169,78,213,221,0,681,
Urosaurus nigricaudus,196,73,181,234,0,684,
Uroteuthis edulis,133,61,282,217,0,693,
Urotrichus talpoides,176,73,211,221,0,681,
Ursus americanus,188,97,207,189,0,681,
Ursus arctos,180,102,214,185,0,681,
Ursus maritimus,183,101,211,186,0,681,
Ursus spelaeus,183,101,210,186,0,680,
Ursus thibetanus,179,102,218,182,0,681,
Ursus thibetanus,177,101,219,184,0,681,
Ursus thibetanus,180,102,216,183,0,681,
Ursus thibetanus,176,101,220,184,0,681,
Ursus thibetanus,181,100,214,186,0,681,
Urticina eques,129,141,255,165,0,690,
Utterbackia imbecillis,77,171,307,147,0,702,
Utterbackia peninsularis,94,172,292,180,0,738,
Uvarovites inflatus,159,72,245,197,0,673,
Vaceletia sp.,65,187,299,156,1,708,
Vaillantella maassi,211,96,170,207,0,684,
Valentia hoffmanni,110,71,262,241,0,684,
Vampyroteuthis infernalis,104,48,326,215,0,693,
Vampyrum spectrum,222,99,176,184,0,681,
Vamuna virilis,96,52,293,237,0,678,
Vanellus cinereus,249,66,167,202,0,684,
Vanellus vanellus,246,63,169,206,0,684,
Vanhornia eucnemidarum,118,44,266,256,0,684,
Vanmanenia pingchowensis,214,91,192,187,0,684,
Varanus niloticus,220,63,187,213,0,683,
Varanus salvator,254,72,162,196,0,684,
Varecia variegata,187,66,218,210,0,681,
Varecia variegata,186,66,218,211,0,681,
Vargula hilgendorfii,176,92,209,171,0,648,
Variola albimarginata,199,80,211,194,0,684,
Variola louti,198,82,211,193,0,684,
Varroa destructor,55,82,293,233,0,663,
Venerupis philippinarum,77,145,329,187,0,738,
Ventrifossa garmani,231,93,192,167,0,683,
Venustaconcha ellipsiformis,60,201,310,125,0,696,
Verasper moseri,214,91,208,171,0,684,
Verasper variegatus,215,94,205,169,0,683,
Versteria mustelae,37,101,273,105,0,516,
Vertigo pusilla,105,82,267,194,0,648,
Vespa mandarinia,113,38,294,221,0,666,
Vespertilio sinensis,174,86,218,203,0,681,
Vestalis melania,169,118,188,203,0,678,
Vestiaria coccinea,240,72,168,204,0,684,
Vicugna vicugna,185,91,206,199,0,681,
Vidua chalybeata,241,73,157,213,0,684,
Vireo olivaceus,232,78,157,217,0,684,
Viridovipera stejnegeri / Trimeresurus stejnegeri stejnegeri,211,65,184,221,0,681,
Viverricula indica,182,72,217,210,0,681,
Vombatus ursinus,208,64,194,215,0,681,
Vulpes corsac,194,88,201,198,0,681,
Vulpes lagopus,197,85,196,203,0,681,
Vulpes vulpes,199,85,195,202,0,681,
Vulpes zerda,201,86,193,201,0,681,
Wadicosa fidelis,55,93,314,204,0,666,
Walchia hayashii,135,49,170,288,0,642,
Wallacidia oculata,115,37,216,271,0,639,
Watasenia scintillans,126,82,293,192,0,693,
Watersipora subtorquata,115,80,239,245,0,679,
Wellcomia siamensis,27,118,339,117,0,601,
Whitmania acranulata,81,99,335,214,0,729,
Whitmania laevis,102,109,312,185,0,708,
Whitmania pigra,77,104,328,196,0,705,
Wiedomys cerradensis,181,74,219,207,0,681,
Wuchereria bancrofti,39,97,335,111,0,582,
Xanthichthys auromarginatus,243,88,187,165,0,683,
Xanthopsar flavus,250,75,159,200,0,684,
Xenagama taylori,207,62,187,226,0,682,
Xenobalistes tumidipectoris,245,86,186,166,0,683,
Xenocatantops brachycerus,108,65,244,261,0,678,
Xenocypris argentea,201,92,196,194,0,683,
Xenocypris davidi,200,92,196,195,0,683,
Xenograpsus testudinatus,132,70,270,203,0,675,
Xenomystus nigri,217,85,189,192,0,683,
Xenopeltis unicolor,174,74,199,233,0,680,
Xenophysogobio boulengeri,198,84,190,212,0,684,
Xenophysogobio nudicorpa,192,91,207,194,0,684,
Xenopoecilus sarasinorum,175,93,235,181,0,684,
Xenopus (silurana),227,78,205,173,0,683,
Xenopus borealis,166,79,242,197,0,684,
Xenopus laevis,173,71,231,206,0,681,
Xenopus victorianus,185,72,228,199,0,684,
Xenotoca eiseni,191,75,233,184,0,683,
Xenoturbella bocki,190,68,190,254,0,702,
Xestospongia muta,81,133,319,202,0,735,
Xiphias gladius,237,97,188,162,0,684,
Xiphinema americanum,110,89,270,149,0,618,
Xiphophorus hellerii,249,95,178,162,0,684,
Xiphophorus maculatus,246,88,181,168,0,683,
Xizicus fascipes,146,79,246,207,0,678,
Xyleus modestus,129,63,220,263,0,675,
Xyrauchen texanus,195,100,199,193,0,687,
Yaoshanicus arcus,169,90,222,202,0,683,
Yemmalysus parallelus,86,71,262,250,0,669,
Yoma sabina,82,55,307,234,0,678,
Ypthima akragas,84,51,310,233,0,678,
Zacco platypus,181,100,214,189,0,684,
Zacco sieboldii,198,97,204,185,0,684,
Zaglossus bruijni,190,76,216,197,0,679,
Zalophus californianus,206,75,188,212,0,681,
Zanclus cornutus,218,93,212,160,0,683,
Zapteryx exasperata,179,74,223,208,0,684,
Zearaja chilensis,203,75,213,193,0,684,
Zebrasoma flavescens,232,84,189,178,0,683,
Zebrias quagga,231,77,195,181,0,684,
Zebrias zebra,207,86,209,182,0,684,
Zebrias zebrinus,207,86,209,182,0,684,
Zenaida auriculata,252,69,162,200,0,683,
Zenion japonicum,225,84,204,171,0,684,
Zenopsis nebulosus,182,96,228,177,0,683,
Zeus faber,186,79,238,180,0,683,
Ziphius cavirostris,196,67,202,216,0,681,
Zootermopsis angusticollis,141,71,177,292,0,681,
Zootermopsis nevadensis,142,70,180,289,0,681,
Zorotypus medoensis,120,51,245,243,0,659,
Zu cristatus,183,93,244,163,0,683,
Zygeupolia rubens,56,180,343,114,0,693,
